TTAAATAACG	TTCGTTATTT
TTAAATTAGC	TTGCTAATTT
TTAATTAACC	TTGGTTAATT
TTAATTACTG	TTCAGTAATT
TTAATTGTAG	TTCTACAATT
TTAATCTTCT	TTAGAAGATT
TTAACTAAAG	TTCTTTAGTT
TTAACTCTTA	TTTAAGAGTT
TTATAAAGTC	TTGACTTTAT
TTATAAACAG	TTCTGTTTAT
TTATAAGTGA	TTTCACTTAT
TTATATACCC	TTGGGTATAT
TTATATGGAG	TTCTCCATAT
TTATAGATCA	TTTGATCTAT
TTATAGTACC	TTGGTACTAT
TTATTATCCA	TTTGGATAAT
TTAGGTAAAT	TTATTTACCT
TTATGTAATG	TTCATTACAT
TTATGTCATA	TTTATGACAT
TTAGTATGAT	TTATCATACT
TTAGAATTTG	TTCAAATTCT
TTACTAATCA	TTTGATTAGT
TTACTAGATA	TTTATCTAGT
TTCACATTTA	TTTAAATGTG
TTTATATCGA	TTTCGATATA
TTCGTCTATA	TTTATAGACG
TTGCTTAATA	TTTATTAAGC
TTTATCTCAA	TTTTGAGATA
TTTAGATGAA	TTTTCATCTA
TTGGTCTTAA	TTTTAAGACC
TTTGGAATAA	TTTTATTCCA
TTGGTTCTAA	TTTTAGAACC
TTCGTAGTAA	TTTTACTACG
TTGCTTTAAA	TTTTTAAAGC
TTGCATTAAA	TTTTTAATGC
TTTCTTACAA	TTTTGTAAGA
TTTGATACAA	TTTTGTATCA
TTTCTTATCA	TTTGATAAGA
TTTGATAACA	TTTGTTATCA
TTCCTTAACA	TTTGTTAAGG
TTTCAATAGA	TTTCTATTGA
TTCTCTATGA	TTTCATAGAG
TTCTATCTGA	TTTCAGATAG
TTGACTAAGA	TTTCTTAGTC
TTCGTATTTC	TTGAAATACG
TTGAAACTTC	TTGAAGTTTC
TTGAATACAC	TTGTGTATTC
TTGATATAGC	TTGCTATATC
TTCTAACATC	TTGATGTTAG
TTCAAGTAAC	TTGTTACTTG
TTCAAATAGG	TTCCTATTTG
TTCTGTAAAG	TTCTTTACAG
