TTAAAGACG	TTCGTCTTT
TTAATAGGC	TTGCCTATT
TTAATGTCG	TTCGACATT
TTAATCACC	TTGGTGATT
TTAAGATGG	TTCCATCTT
TTAAGAGTC	TTGACTCTT
TTAAGTACG	TTCGTACTT
TTAACACTT	TTAAGTGTT
TTAACATGG	TTCCATGTT
TTATATCCG	TTCGGATAT
TTATTGTGG	TTCCACAAT
TTATTCACG	TTCGTGAAT
TTATGAAGG	TTCCTTCAT
TTATGTACC	TTGGTACAT
TTATCTGGA	TTTCCAGAT
TTAGAAGTC	TTGACTTCT
TTAGATACG	TTCGTATCT
TTACAAACC	TTGGTTTGT
TTACTATCG	TTCGATAGT
TTACCTAGA	TTTCTAGGT
TTGCCATTA	TTTAATGGC
TTGCTGTTA	TTTAACAGC
TTGGAGTTA	TTTAACTCC
TTGGTTCTA	TTTAGAACC
TTCGATCTA	TTTAGATCG
TTCAGTCTA	TTTAGACTG
TTGCTACTA	TTTAGTAGC
TTGCTTGTA	TTTACAAGC
TTCGTTGTA	TTTACAACG
TTTACTCGA	TTTCGAGTA
TTCGGTTAA	TTTTAACCG
TTCGCATAA	TTTTATGCG
TTGCAGTAA	TTTTACTGC
TTGCTCAAA	TTTTTGAGC
TTTGTCCAA	TTTTGGACA
TTTTCCCAA	TTTTGGGAA
TTCCTTTCA	TTTGAAAGG
TTCGTTTCA	TTTGAAACG
TTCAGTTCA	TTTGAACTG
TTCGTAACA	TTTGTTACG
TTCGTAAGA	TTTCTTACG
TTCTCAGGA	TTTCCTGAG
TTCCTCATC	TTGATGAGG
TTGATGACC	TTGGTCATC
TTGACTAGC	TTGCTAGTC
TTCGTAGTC	TTGACTACG
TTCGATACC	TTGGTATCG
TTCTCTACC	TTGGTAGAG
TTCCATAGC	TTGCTATGG
TTCAAATCG	TTCGATTTG
TTCAACTTG	TTCAAGTTG
TTCTGACAG	TTCTGTCAG
TTCCTACAG	TTCTGTAGG
TTCCTAACG	TTCGTTAGG
TTCCTAAGG	TTCCTTAGG
