TTAAATGCA	TTTGCATTT
TTAATCAGG	TTCCTGATT
TTAATCCAC	TTGTGGATT
TTAAGTACC	TTGGTACTT
TTAACAACA	TTTGTTGTT
TTATATGGC	TTGCCATAT
TTATACAGC	TTGCTGTAT
TTATACTGG	TTCCAGTAT
TTATTACCC	TTGGGTAAT
TTATTGACC	TTGGTCAAT
TTATGTCAC	TTGTGACAT
TTATCTACG	TTCGTAGAT
TTATCTCAC	TTGTGAGAT
TTAGATTGG	TTCCAATCT
TTAGTTACG	TTCGTAACT
TTAGTTTGG	TTCCAAACT
TTAGTGTTA	TTTAACACT
TTAGGTAGA	TTTCTACCT
TTACAATGT	TTACATTGT
TTACTAAGC	TTGCTTAGT
TTACTAACG	TTCGTTAGT
TTACTATCG	TTCGATAGT
TTCGTCTTA	TTTAAGACG
TTCGACTTA	TTTAAGTCG
TTGCCTATA	TTTATAGGC
TTCGGAATA	TTTATTCCG
TTGCTCATA	TTTATGAGC
TTGGTGATA	TTTATCACC
TTCGTTCTA	TTTAGAACG
TTCCTTGTA	TTTACAAGG
TTCGATGTA	TTTACATCG
TTGCTAGTA	TTTACTAGC
TTCGGTTAA	TTTTAACCG
TTCGCTAAA	TTTTTAGCG
TTCGTGAAA	TTTTTCACG
TTCGAGAAA	TTTTTCTCG
TTGCTTCAA	TTTTGAAGC
TTCGATCAA	TTTTGATCG
TTTCCTCAA	TTTTGAGGA
TTGCTACAA	TTTTGTAGC
TTCGTACAA	TTTTGTACG
TTCCAAGAA	TTTTCTTGG
TTCCTTTCA	TTTGAAAGG
TTGGTTTCA	TTTGAAACC
TTCCATTCA	TTTGAATGG
TTCGATTCA	TTTGAATCG
TTGAGTTCA	TTTGAACTC
TTGCTATGA	TTTCATAGC
TTCGTATGA	TTTCATACG
TTCAGATGA	TTTCATCTG
TTCCCTAGA	TTTCTAGGG
TTCGTAAGA	TTTCTTACG
TTCCAAAGA	TTTCTTTGG
TTCCTACTC	TTGAGTAGG
TTCAGACTC	TTGAGTCTG
TTCAGAGAC	TTGTCTCTG
TTCGATACC	TTGGTATCG
TTCAACTTG	TTCAAGTTG
TTCAGAAGG	TTCCTTCTG
