TTAAATTAGC	TTGCTAATTT
TTAATAATCG	TTCGATTATT
TTAATTACTG	TTCAGTAATT
TTAATCTTCT	TTAGAAGATT
TTAATCTCAA	TTTTGAGATT
TTAACTCTTA	TTTAAGAGTT
TTATAAAGTC	TTGACTTTAT
TTATAAGTGA	TTTCACTTAT
TTATATGACA	TTTGTCATAT
TTATATGGAG	TTCTCCATAT
TTATATCAGG	TTCCTGATAT
TTATAGATCA	TTTGATCTAT
TTATAGTAGG	TTCCTACTAT
TTATTTAACC	TTGGTTAAAT
TTAGGTAAAT	TTATTTACCT
TTAGTATGAT	TTATCATACT
TTAGAATACT	TTAGTATTCT
TTAGAATTTG	TTCAAATTCT
TTACTAGATA	TTTATCTAGT
TTCGTTATTA	TTTAATAACG
TTCGTCTATA	TTTATAGACG
TTTAGATGAA	TTTTCATCTA
TTGGTCTTAA	TTTTAAGACC
TTTGGAATAA	TTTTATTCCA
TTCCTCATAA	TTTTATGAGG
TTGGACATAA	TTTTATGTCC
TTGGTACTAA	TTTTAGTACC
TTTGAACTAA	TTTTAGTTCA
TTCCTTGTAA	TTTTACAAGG
TTTTACAGAA	TTTTCTGTAA
TTCGTAGTAA	TTTTACTACG
TTGCTTTAAA	TTTTTAAAGC
TTCGTTTAAA	TTTTTAAACG
TTGCATTAAA	TTTTTAATGC
TTGGGATAAA	TTTTTATCCC
TTTGATACAA	TTTTGTATCA
TTCTCTACAA	TTTTGTAGAG
TTCAAATGAA	TTTTCATTTG
TTTGTTAGAA	TTTTCTAACA
TTTCTTATCA	TTTGATAAGA
TTCCTAATCA	TTTGATTAGG
TTCCTTAACA	TTTGTTAAGG
TTCTCTATGA	TTTCATAGAG
TTCCTTTAGA	TTTCTAAAGG
TTGGTTTAGA	TTTCTAAACC
TTCAGATAGA	TTTCTATCTG
TTGACTAAGA	TTTCTTAGTC
TTGTGTAAGA	TTTCTTACAC
TTCGTATTTC	TTGAAATACG
TTGAAACTTC	TTGAAGTTTC
TTGATAACAC	TTGTGTTATC
TTGATGTAAC	TTGTTACATC
TTCAAGTAAC	TTGTTACTTG
TTCAAAGAAC	TTGTTCTTTG
TTCCTATACC	TTGGTATAGG
TTCTAATAGC	TTGCTATTAG
TTCAAATAGG	TTCCTATTTG
TTCAATAAGG	TTCCTTATTG
TTCAATATCG	TTCGATATTG
TTCACATTAG	TTCTAATGTG
TTCGTAATAG	TTCTATTACG
