AAATAGGC	GCCTATTT
AATTCACT	AGTGAATT
AATGAAGG	CCTTCATT
AATCATGG	CCATGATT
AATCACCA	TGGTGATT
AAGTTACG	CGTAACTT
AAGGAACC	GGTTCCTT
AACAAACT	AGTTTGTT
AACTTAGC	GCTAAGTT
AGCTTTAT	ATAAAGCT
ATAATCGG	CCGATTAT
ATAAGAGC	GCTCTTAT
ATATTGGG	CCCAATAT
ATATCTGC	GCAGATAT
ATAGAAGC	GCTTCTAT
ATTAGGGC	GCCCTAAT
ATTTGCAG	CTGCAAAT
ATTTCCAG	CTGGAAAT
ATTGACAA	TTGTCAAT
ATTGTTCG	CGAACAAT
ATTCAACG	CGTTGAAT
ATTCTTGG	CCAAGAAT
ATTCCCGG	CCGGGAAT
ATGATGCG	CGCATCAT
ATGGACAC	GTGTCCAT
AGAGATGG	CCATCTCT
AGACATTA	TAATGTCT
AGACTTCC	GGAAGTCT
AGTAAACG	CGTTTACT
AGGATACT	AGTATCCT
AGTACCTC	GAGGTACT
AGTGTTAC	GTAACACT
AGTCACGA	TCGTGACT
AGCTAGAA	TTCTAGCT
AGCTGACC	GGTCAGCT
ACTATTGC	GCAATAGT
ACTTTAGC	GCTAAAGT
ACTTTGAA	TTCAAAGT
ACTGTTTA	TAAACAGT
GGATGTTA	TAACATCC
GGCGTATA	TATACGCC
TATTACCA	TGGTAATA
GCTACATA	TATGTAGC
GGTTTCTA	TAGAAACC
TAGAACTA	TAGTTCTA
GAGCACTA	TAGTGCTC
CCAGTTAA	TTAACTGG
TCGAATAA	TTATTCGA
GCCTTAAA	TTTAAGGC
TCGAGAAA	TTTCTCGA
TCATTGAA	TTCAATGA
CGAAAGAA	TTCTTTCG
TGAAATCA	TGATTTCA
GCTATTCA	TGAATAGC
GCTTATCA	TGATAAGC
CGTTATCA	TGATAACG
CGTAATCA	TGATTACG
GACAATCA	TGATTGTC
CGGTCTCA	TGAGACCG
CCATTACA	TGTAATGG
GCTTAACA	TGTTAAGC
GTTAGCCA	TGGCTAAC
GGAATTGA	TCAATTCC
GCATTAGA	TCTAATGC
CAAGTAGA	TCTACTTG
GCATAAGA	TCTTATGC
CAGTAAGA	TCTTACTG
CACTAGGA	TCCTAGTG
CATCAGGA	TCCTGATG
CGATCTTC	GAAGATCG
CGTAGATC	GATCTACG
CCATTCTC	GAGAATGG
GACTAACC	GGTTAGTC
GCTCATAC	GTATGAGC
CGTCATAC	GTATGACG
CCGACTAC	GTAGTCGG
CAGAGTAC	GTACTCTG
GGGTTAAC	GTTAACCC
GCTCCAAC	GTTGGAGC
GCATAGAC	GTCTATGC
CGGTAGAC	GTCTACCG
CTTCAGAC	GTCTGAAG
CGGATTCC	GGAATCCG
GCATATCC	GGATATGC
CGCTATCC	GGATAGCG
CTTGATCC	GGATCAAG
GCTAAACC	GGTTTAGC
CAATACCC	GGGTATTG
CATGTGGC	GCCACATG
CTTGAGGC	GCCTCAAG
CATATGGG	CCCATATG
CAGTATGG	CCATACTG
CACTATCG	CGATAGTG
CGTCTTAG	CTAAGACG
CCTTGTAG	CTACAAGG
CGTTCAAG	CTTGAACG
CCGTACAG	CTGTACGG
CCAAATGG	CCATTTGG
