TTGTATCAG	TTCTGATAC
TTCCTAATC	TTGATTAGG
TTCTGAACT	TTAGTTCAG
TTCATTTGC	TTGCAAATG
TTCTTATGC	TTGCATAAG
TTGTATGAG	TTCTCATAC
TTTTTAGCC	TTGGCTAAA
TTGTAAGAC	TTGTCTTAC
TTCGGAAAA	TTTTTTCCG
TTTTACACC	TTGGTGTAA
TTGTTACAG	TTCTGTAAC
TTTTTGACC	TTGGTCAAA
TTGTTGCAA	TTTTGCAAC
TTGATTTCC	TTGGAAATC
TTGATTGTC	TTGACAATC
TTGTAGAAG	TTCTTCTAC
TTCAAACTC	TTGAGTTTG
TTCTTTGAG	TTCTCAAAG
TTCCTTACT	TTAGTAAGG
TTCGCAAAA	TTTTTTGCG
TTGTTTCAC	TTGTGAAAC
TTCTTCTGT	TTACAGAAG
TTCTTTTCC	TTGGAAAAG
TTGATAACC	TTGGTTATC
TTAAGAGAG	TTCTCTCTT
TTCTAGATC	TTGATCTAG
TTGTTTGTC	TTGACAAAC
TTGGAATTC	TTGAATTCC
TTGATGTCG	TTCGACATC
TTGTGATAG	TTCTATCAC
TTCTTGTGT	TTACACAAG
TTGTGAATC	TTGATTCAC
