TTTAGTGGA	TTTCCACTA
TTACCTCAA	TTTTGAGGT
TTACCCTAG	TTCTAGGGT
TTTAACAGC	TTGCTGTTA
TTTATTGGC	TTGCCAATA
TTATATGCG	TTCGCATAT
TTCATCCTG	TTCAGGATG
TTTATGACG	TTCGTCATA
TTAACAACC	TTGGTTGTT
TTGCTCATA	TTTATGAGC
TTTCAAACC	TTGGTTTGA
TTTATTCCG	TTCGGAATA
TTTAGAAGC	TTGCTTCTA
TTAACATCG	TTCGATGTT
TTACAATCG	TTCGATTGT
TTGTGAACC	TTGGTTCAC
TTTCTTGTT	TTAACAAGA
TTACATTGA	TTTCAATGT
TTTAACTCC	TTGGAGTTA
TTGGACTTA	TTTAAGTCC
TTTCTGATG	TTCATCAGA
TTAGAAACG	TTCGTTTCT
TTTTTAGCG	TTCGCTAAA
TTATTTGGG	TTCCCAAAT
TTTTACACG	TTCGTGTAA
TTAAGACTG	TTCAGTCTT
TTTTACTGC	TTGCAGTAA
TTAATCACC	TTGGTGATT
TTGGTTACG	TTCGTAACC
TTATAAGGC	TTGCCTTAT
TTACAAAGT	TTACTTTGT
TTCTGTACG	TTCGTACAG
TTAGAACTG	TTCAGTTCT
TTATGTCAC	TTGTGACAT
TTGCTACAG	TTCTGTAGC
TTCTTACCG	TTCGGTAAG
TTTACTAGC	TTGCTAGTA
TTTTCATGG	TTCCATGAA
TTTTTGACC	TTGGTCAAA
TTTCATACG	TTCGTATGA
TTAATCTGG	TTCCAGATT
TTACTTCAC	TTGTGAAGT
TTTTGATCG	TTCGATCAA
TTAAGATGG	TTCCATCTT
TTTCATAGC	TTGCTATGA
TTGGTACTC	TTGAGTACC
TTAGAATGG	TTCCATTCT
TTTTTCTCG	TTCGAGAAA
TTACTAACG	TTCGTTAGT
TTCGTAAGT	TTACTTACG
TTGCTTAGT	TTACTAAGC
TTATAGTCG	TTCGACTAT
TTCCTTTCT	TTAGAAAGG
TTGGATCTT	TTAAGATCC
TTATCTCAC	TTGTGAGAT
TTCAAGTTG	TTCAACTTG
TTGAGTAGG	TTCCTACTC
TTAAGAGAC	TTGTCTCTT
TTGGATTCT	TTAGAATCC
TTCGATAGG	TTCCTATCG
TTCGTAGAT	TTATCTACG
TTGGATACC	TTGGTATCC
TTGTCTACC	TTGGTAGAC
TTAGTATCG	TTCGATACT
