TTCGTTCTA	TTTAGAACG
TTCAAATCG	TTCGATTTG
TTATTACCC	TTGGGTAAT
TTCAAAGTG	TTCACTTTG
TTCGGTTAA	TTTTAACCG
TTAGAAAGG	TTCCTTTCT
TTCGATCTA	TTTAGATCG
TTAGAAACC	TTGGTTTCT
TTAAAAACG	TTCGTTTTT
TTCCATTCA	TTTGAATGG
TTAAGATGG	TTCCATCTT
TTCCTATCG	TTCGATAGG
TTCACTCTA	TTTAGAGTG
TTGGATTCA	TTTGAATCC
TTATTCTGG	TTCCAGAAT
TTCGTAAGA	TTTCTTACG
TTCGGAATA	TTTATTCCG
TTGAGTACC	TTGGTACTC
TTACATAGC	TTGCTATGT
TTGGATACC	TTGGTATCC
TTACATACG	TTCGTATGT
TTAGTTACG	TTCGTAACT
TTATACAGC	TTGCTGTAT
TTGCTCATA	TTTATGAGC
TTCAACTTG	TTCAAGTTG
TTCGAGTTA	TTTAACTCG
TTGCCATAA	TTTTATGGC
TTCGCTAAA	TTTTTAGCG
TTAAGACTC	TTGAGTCTT
TTCAACATG	TTCATGTTG
TTACTAAGC	TTGCTTAGT
TTACTAACG	TTCGTTAGT
TTCACTAGG	TTCCTAGTG
TTAAGTAGC	TTGCTACTT
TTATGAAGG	TTCCTTCAT
TTAATCAGG	TTCCTGATT
TTATGAACC	TTGGTTCAT
TTCAAAAGC	TTGCTTTTG
TTAATCACC	TTGGTGATT
TTATTGAGG	TTCCTCAAT
TTGATGTGA	TTTCACATC
TTATGATCC	TTGGATCAT
TTCCTACAC	TTGTGTAGG
TTAAACTGA	TTTCAGTTT
TTAATCTCC	TTGGAGATT
TTCAAACAC	TTGTGTTTG
TTATCTAGC	TTGCTAGAT
TTGGGAAAA	TTTTTTCCC
TTATCTACG	TTCGTAGAT
TTATAGACG	TTCGTCTAT
TTCTCAGAG	TTCTCTGAG
TTATGACAC	TTGTGTCAT
TTCGTACAA	TTTTGTACG
TTCACTACC	TTGGTAGTG
TTCGATGAA	TTTTCATCG
TTATAGTCG	TTCGACTAT
TTACAATGT	TTACATTGT
TTATTAGGC	TTGCCTAAT
TTGGACTTA	TTTAAGTCC
TTAGTATCG	TTCGATACT
TTCAAATGC	TTGCATTTG
TTACAAGAG	TTCTCTTGT
TTGACCTTA	TTTAAGGTC
TTGCTTCTA	TTTAGAAGC
