TTAAAATGC	TTGCATTTT
TTAAAGTCC	TTGGACTTT
TTAAGTTGA	TTTCAACTT
TTAACAAGA	TTTCTTGTT
TTAACTAGC	TTGCTAGTT
TTAACTGTA	TTTACAGTT
TTATAGAGC	TTGCTCTAT
TTATAGACG	TTCGTCTAT
TTATAGGTG	TTCACCTAT
TTATCAGGA	TTTCCTGAT
TTAGAACAC	TTGTGTTCT
TTAGATACG	TTCGTATCT
TTGGTCATA	TTTATGACC
TTTATCCGA	TTTCGGATA
TTGCCTTAA	TTTTAAGGC
TTGCCAAAA	TTTTTTGGC
TTTCGAGAA	TTTTCTCGA
TTGGAATCA	TTTGATTCC
TTGGATTGA	TTTCAATCC
TTGTGATGA	TTTCATCAC
TTCAAGTGA	TTTCACTTG
TTCTGAGGA	TTTCCTCAG
TTGAAAAGC	TTGCTTTTC
TTCGCTATC	TTGATAGCG
TTGACTCAC	TTGTGAGTC
TTCGACTAC	TTGTAGTCG
TTCGATACC	TTGGTATCG
TTCTAACCC	TTGGGTTAG
TTCCCTAAG	TTCTTAGGG
TTCTGACAG	TTCTGTCAG
