TTAAAATGC	TTGCATTTT
TTAAAGTCC	TTGGACTTT
TTAAGTTGA	TTTCAACTT
TTAAGGTCA	TTTGACCTT
TTAACAAGA	TTTCTTGTT
TTAACTAGC	TTGCTAGTT
TTATAGAGC	TTGCTCTAT
TTATAGACG	TTCGTCTAT
TTATTCACC	TTGGTGAAT
TTATGAACG	TTCGTTCAT
TTATCAGGA	TTTCCTGAT
TTAGATTCC	TTGGAATCT
TTACATACG	TTCGTATGT
TTACAGTAC	TTGTACTGT
TTACACTTA	TTTAAGTGT
TTCTCCATA	TTTATGGAG
TTGCCAAAA	TTTTTTGGC
TTTCCTCAA	TTTTGAGGA
TTTCGAGAA	TTTTCTCGA
TTGGATTGA	TTTCAATCC
TTCCCTAGA	TTTCTAGGG
TTGAAAAGC	TTGCTTTTC
TTCGCTATC	TTGATAGCG
TTGACTCAC	TTGTGAGTC
TTCGACTAC	TTGTAGTCG
TTCTGTCAC	TTGTGACAG
TTCTCATCC	TTGGATGAG
TTCGTTACC	TTGGTAACG
TTCGATACC	TTGGTATCG
TTCTAACCC	TTGGGTTAG
TTCCTAAGC	TTGCTTAGG
