TTAAAGTGG	TTCCACTTT
TTAATCACG	TTCGTGATT
TTAAGAGTC	TTGACTCTT
TTAAGACTG	TTCAGTCTT
TTAAGTACC	TTGGTACTT
TTAAGTTGA	TTTCAACTT
TTAACATCG	TTCGATGTT
TTAACTAGC	TTGCTAGTT
TTAACTGTA	TTTACAGTT
TTATAGAGC	TTGCTCTAT
TTATAGACG	TTCGTCTAT
TTATAGGTG	TTCACCTAT
TTATACTCG	TTCGAGTAT
TTATTACGC	TTGCGTAAT
TTATTGTCG	TTCGACAAT
TTATTGCAG	TTCTGCAAT
TTATGATGG	TTCCATCAT
TTATCAAGG	TTCCTTGAT
TTAGAAAGG	TTCCTTTCT
TTAGAATGG	TTCCATTCT
TTAGATACG	TTCGTATCT
TTAGTAGGG	TTCCCTACT
TTACAAACA	TTTGTTTGT
TTACATTGA	TTTCAATGT
TTACTAAGC	TTGCTTAGT
TTACTATCG	TTCGATAGT
TTGGCATTA	TTTAATGCC
TTGGTCATA	TTTATGACC
TTGGCTAAA	TTTTTAGCC
TTGACTTCA	TTTGAAGTC
TTGAGAACA	TTTGTTCTC
TTCTACCCA	TTTGGGTAG
TTGGATTGA	TTTCAATCC
TTGCTATGA	TTTCATAGC
TTGAAAAGC	TTGCTTTTC
TTCGTTTTC	TTGAAAACG
TTGAACTCC	TTGGAGTTC
TTGAGAAGC	TTGCTTCTC
TTCGATCTC	TTGAGATCG
TTCGTAGTC	TTGACTACG
TTCGGATAC	TTGTATCCG
TTGCTACAC	TTGTGTAGC
TTCTGATCC	TTGGATCAG
TTGGTAACC	TTGGTTACC
TTCCTAACC	TTGGTTAGG
TTCAAATCG	TTCGATTTG
TTCATCTGG	TTCCAGATG
TTCAGGATG	TTCATCCTG
TTCGGTAAG	TTCTTACCG
TTCTGACAG	TTCTGTCAG
