TTAAAGTCC	TTGGACTTT
TTAATACCG	TTCGGTATT
TTAATCAGC	TTGCTGATT
TTAATCTCG	TTCGAGATT
TTAAGAAGC	TTGCTTCTT
TTAAGAGTG	TTCACTCTT
TTAACATCC	TTGGATGTT
TTAACTAGC	TTGCTAGTT
TTATAGTCG	TTCGACTAT
TTATGATCC	TTGGATCAT
TTATCAACC	TTGGTTGAT
TTATCTGTC	TTGACAGAT
TTAGAAACG	TTCGTTTCT
TTAGACAAC	TTGTTGTCT
TTAGTATCG	TTCGATACT
TTAGGTACA	TTTGTACCT
TTACAATGA	TTTCATTGT
TTACAAGTG	TTCACTTGT
TTACTTACC	TTGGTAAGT
TTGGTGTTA	TTTAACACC
TTGGTCATA	TTTATGACC
TTGCACATA	TTTATGTGC
TTCGTGATA	TTTATCACG
TTTAGGGAA	TTTTCCCTA
TTGCCTTAA	TTTTAAGGC
TTCGCATAA	TTTTATGCG
TTGCCAAAA	TTTTTTGGC
TTTGAGGAA	TTTTCCTCA
TTGGATTCA	TTTGAATCC
TTGAAAAGC	TTGCTTTTC
TTGAACTCC	TTGGAGTTC
TTCGTTCTC	TTGAGAACG
TTGGTAACC	TTGGTTACC
TTCGATAGC	TTGCTATCG
TTCAGTAGC	TTGCTACTG
TTCAAACTG	TTCAGTTTG
TTCATACGG	TTCCGTATG
