TTAAAAACG	TTCGTTTTT
TTAAAGAGC	TTGCTCTTT
TTAAAGTCC	TTGGACTTT
TTAAAGGTA	TTTACCTTT
TTAATGAGG	TTCCTCATT
TTAAGAAGG	TTCCTTCTT
TTAAGAACC	TTGGTTCTT
TTAAGATCC	TTGGATCTT
TTAAGACAT	TTATGTCTT
TTAACAGTT	TTAACTGTT
TTAACTAGC	TTGCTAGTT
TTAACTACG	TTCGTAGTT
TTATTGCAG	TTCTGCAAT
TTATTCACG	TTCGTGAAT
TTATGTGAG	TTCTCACAT
TTATCATCC	TTGGATGAT
TTATCAGGA	TTTCCTGAT
TTATCTCGA	TTTCGAGAT
TTAGAAAGC	TTGCTTTCT
TTAGATACG	TTCGTATCT
TTAGTAACG	TTCGTTACT
TTACAAACC	TTGGTTTGT
TTACAATCC	TTGGATTGT
TTACATTCC	TTGGAATGT
TTACTATCG	TTCGATAGT
TTACTTACG	TTCGTAAGT
TTACCCTAG	TTCTAGGGT
TTGCCTATA	TTTATAGGC
TTCGGTATA	TTTATACCG
TTGGTCATA	TTTATGACC
TTGGTGATA	TTTATCACC
TTCGTACTA	TTTAGTACG
TTGTCACTA	TTTAGTGAC
TTTAGTCGA	TTTCGACTA
TTCCTTGTA	TTTACAAGG
TTCGTTGTA	TTTACAACG
TTCGATGTA	TTTACATCG
TTCGCATAA	TTTTATGCG
TTGCCAAAA	TTTTTTGGC
TTCGTCAAA	TTTTTGACG
TTGCTTCAA	TTTTGAAGC
TTCGTTCAA	TTTTGAACG
TTCGATCAA	TTTTGATCG
TTCGATTCA	TTTGAATCG
TTGCTAACA	TTTGTTAGC
TTGCTATGA	TTTCATAGC
TTCTGGAGA	TTTCTCCAG
TTCCTACTC	TTGAGTAGG
TTGAGTTCC	TTGGAACTC
TTCCCATAC	TTGTATGGG
TTCGGATAC	TTGTATCCG
TTGGTACAC	TTGTGTACC
TTCTCTGAC	TTGTCAGAG
TTCTCTACC	TTGGTAGAG
TTCGTAACC	TTGGTTACG
TTCCTTAGC	TTGCTAAGG
TTCTGTAGC	TTGCTACAG
TTCAACTTG	TTCAAGTTG
TTCAACATG	TTCATGTTG
