TTAAGAACG	TTCGTTCTT
TTAACAACT	TTAGTTGTT
TTAACAGAC	TTGTCTGTT
TTATATCGC	TTGCGATAT
TTATAGAGC	TTGCTCTAT
TTATAGACG	TTCGTCTAT
TTATACTGC	TTGCAGTAT
TTATGAGGA	TTTCCTCAT
TTAGATACG	TTCGTATCT
TTAGGTACT	TTAGTACCT
TTAGTCACT	TTAGTGACT
TTACAATGT	TTACATTGT
TTACTTACC	TTGGTAAGT
TTACTTGTA	TTTACAAGT
TTACTCTTC	TTGAAGAGT
TTGTCCTTA	TTTAAGGAC
TTCGTGTTA	TTTAACACG
TTGGTCATA	TTTATGACC
TTGCTGATA	TTTATCAGC
TTGCCAAAA	TTTTTTGGC
TTGTGTCAA	TTTTGACAC
TTGCTACAA	TTTTGTAGC
TTTCCATCA	TTTGATGGA
TTGGATTGA	TTTCAATCC
TTGCTATGA	TTTCATAGC
TTCCCTAGA	TTTCTAGGG
TTCCTGAGA	TTTCTCAGG
TTGAAAAGC	TTGCTTTTC
TTCGTTTTC	TTGAAAACG
TTGATAGGC	TTGCCTATC
TTGATCTCC	TTGGAGATC
TTCTAACCC	TTGGGTTAG
TTCCTAAGC	TTGCTTAGG
TTCATACCG	TTCGGTATG
TTCATCTGG	TTCCAGATG
