TTAAAGAGC	TTGCTCTTT
TTAAAGTCG	TTCGACTTT
TTAATTCCG	TTCGGAATT
TTAATCTCC	TTGGAGATT
TTAAGATGG	TTCCATCTT
TTAAGATCC	TTGGATCTT
TTAAGGTAC	TTGTACCTT
TTAACTACC	TTGGTAGTT
TTAACTCAT	TTATGAGTT
TTATAGACG	TTCGTCTAT
TTATACAGC	TTGCTGTAT
TTATTAGCG	TTCGCTAAT
TTATTGAGG	TTCCTCAAT
TTATCAACC	TTGGTTGAT
TTATCTACG	TTCGTAGAT
TTAGAAACC	TTGGTTTCT
TTAGAATCG	TTCGATTCT
TTAGTATCG	TTCGATACT
TTAGTAGGG	TTCCCTACT
TTAGTTCTG	TTCAGAACT
TTACAATGT	TTACATTGT
TTACTAAGC	TTGCTTAGT
TTACTTGTA	TTTACAAGT
TTCCACTTA	TTTAAGTGG
TTCGTGTTA	TTTAACACG
TTGCCAATA	TTTATTGGC
TTGGTCATA	TTTATGACC
TTCGATGTA	TTTACATCG
TTGCCTAAA	TTTTTAGGC
TTCCCAAAA	TTTTTTGGG
TTGGTTCAA	TTTTGAACC
TTGCTACAA	TTTTGTAGC
TTTCGAGAA	TTTTCTCGA
TTCCTTTCA	TTTGAAAGG
TTCCATTCA	TTTGAATGG
TTGCTATGA	TTTCATAGC
TTCTCAGGA	TTTCCTGAG
TTGAAAAGC	TTGCTTTTC
TTCGTTTTC	TTGAAAACG
TTCCATGTC	TTGACATGG
TTCCTAGTC	TTGACTAGG
TTCGGTAAC	TTGTTACCG
TTCGATCAC	TTGTGATCG
TTGGATACC	TTGGTATCC
TTCCTAACC	TTGGTTAGG
TTCTCTAGC	TTGCTAGAG
TTCAGAAGG	TTCCTTCTG
TTCAGACTG	TTCAGTCTG
TTCAGTACG	TTCGTACTG
TTCCTATCG	TTCGATAGG
TTCCATACG	TTCGTATGG
