TTAAAGTCG	TTCGACTTT
TTAAACTCC	TTGGAGTTT
TTAATTCCG	TTCGGAATT
TTAATCACC	TTGGTGATT
TTAAGAGTC	TTGACTCTT
TTATAGACG	TTCGTCTAT
TTATTAGCC	TTGGCTAAT
TTACAAGAT	TTATCTTGT
TTATCTCGA	TTTCGAGAT
TTAGAAAGG	TTCCTTTCT
TTAGAAACC	TTGGTTTCT
TTAGAATGG	TTCCATTCT
TTAGATACG	TTCGTATCT
TTAGTAACC	TTGGTTACT
TTAGTAGGG	TTCCCTACT
TTAGTTGTA	TTTACAACT
TTACAATGT	TTACATTGT
TTACTATCG	TTCGATAGT
TTGGTCTTA	TTTAAGACC
TTCCCAATA	TTTATTGGG
TTGCTCATA	TTTATGAGC
TTGGACATA	TTTATGTCC
TTCGTTCTA	TTTAGAACG
TTTAGTGGA	TTTCCACTA
TTCGATGTA	TTTACATCG
TTGCTGTAA	TTTTACAGC
TTCGGTAAA	TTTTTACCG
TTCGATCAA	TTTTGATCG
TTTCCTCAA	TTTTGAGGA
TTGCTACAA	TTTTGTAGC
TTCGATTCA	TTTGAATCG
TTGTGAACA	TTTGTTCAC
TTCGTAAGA	TTTCTTACG
TTGTGAAGA	TTTCTTCAC
TTCTCTGGA	TTTCCAGAG
TTCGTTTTC	TTGAAAACG
TTCGCTATC	TTGATAGCG
TTGACTAGC	TTGCTAGTC
TTCGTAGTC	TTGACTACG
TTGTCTCAC	TTGTGAGAC
TTCGTACAC	TTGTGTACG
TTCAAACAC	TTGTGTTTG
TTCAGATCC	TTGGATCTG
TTCGATACC	TTGGTATCG
TTCTCTACC	TTGGTAGAG
TTCAGTACC	TTGGTACTG
TTCCTAACC	TTGGTTAGG
TTCTATGCC	TTGGCATAG
TTCATCAGG	TTCCTGATG
TTCAGAAGG	TTCCTTCTG
TTCAGACTG	TTCAGTCTG
TTCCTAAGG	TTCCTTAGG
