TTAAAAACG	TTCGTTTTT
TTAATCAGG	TTCCTGATT
TTAAGAAGG	TTCCTTCTT
TTAAGAACC	TTGGTTCTT
TTAAGATCC	TTGGATCTT
TTAACTACC	TTGGTAGTT
TTATTAGCG	TTCGCTAAT
TTATTACGG	TTCCGTAAT
TTATGAAGC	TTGCTTCAT
TTATCATCC	TTGGATGAT
TTATCTAGC	TTGCTAGAT
TTATCTACG	TTCGTAGAT
TTAGAAAGG	TTCCTTTCT
TTAGATTCC	TTGGAATCT
TTAGTAACC	TTGGTTACT
TTAGGTACA	TTTGTACCT
TTACAATGT	TTACATTGT
TTACTATCG	TTCGATAGT
TTCGGTTTA	TTTAAACCG
TTGCTCTTA	TTTAAGAGC
TTCGTCTTA	TTTAAGACG
TTGCCTATA	TTTATAGGC
TTGGTCATA	TTTATGACC
TTGGACATA	TTTATGTCC
TTGGTGATA	TTTATCACC
TTCACTCTA	TTTAGAGTG
TTGGAACTA	TTTAGTTCC
TTTAGTCGA	TTTCGACTA
TTGCTTGTA	TTTACAAGC
TTCGTTGTA	TTTACAACG
TTCGATGTA	TTTACATCG
TTGGAAGTA	TTTACTTCC
TTGCTGTAA	TTTTACAGC
TTCGTGTAA	TTTTACACG
TTCCCAAAA	TTTTTTGGG
TTCGATCAA	TTTTGATCG
TTCAGTCAA	TTTTGACTG
TTTCGAGAA	TTTTCTCGA
TTCTGTTCA	TTTGAACAG
TTCCCTACA	TTTGTAGGG
TTGGAAACA	TTTGTTTCC
TTGGATTGA	TTTCAATCC
TTCCTCAGA	TTTCTGAGG
TTCTGGAGA	TTTCTCCAG
TTGAAAAGC	TTGCTTTTC
TTGAAATGC	TTGCATTTC
TTGAGACAC	TTGTGTCTC
TTCTGTCAC	TTGTGACAG
TTGCTATCC	TTGGATAGC
TTCGTATCC	TTGGATACG
TTCCTTACC	TTGGTAAGG
TTCGATACC	TTGGTATCG
TTCAGTAGC	TTGCTACTG
TTCCTAAGC	TTGCTTAGG
TTCTATGGC	TTGCCATAG
TTCAAATCG	TTCGATTTG
TTCAAAGTG	TTCACTTTG
TTCAAACTG	TTCAGTTTG
TTCAACTTG	TTCAAGTTG
TTCAACATG	TTCATGTTG
TTCAGTACG	TTCGTACTG
TTCACTAGG	TTCCTAGTG
TTCCTAACG	TTCGTTAGG
