TTAAAAACG	TTCGTTTTT
TTAATCAGG	TTCCTGATT
TTAAGATCC	TTGGATCTT
TTAACATGG	TTCCATGTT
TTATATGCG	TTCGCATAT
TTATAGTCG	TTCGACTAT
TTATACACG	TTCGTGTAT
TTATTAGGC	TTGCCTAAT
TTATTGAGG	TTCCTCAAT
TTATGAAGG	TTCCTTCAT
TTATGATCG	TTCGATCAT
TTATGTCAC	TTGTGACAT
TTATCTACG	TTCGTAGAT
TTATCTCAC	TTGTGAGAT
TTAGAAACC	TTGGTTTCT
TTAGTATCG	TTCGATACT
TTAGTTGTA	TTTACAACT
TTACTACCT	TTAGGTAGT
TTACAAAGT	TTACTTTGT
TTACAATGT	TTACATTGT
TTACTAAGC	TTGCTTAGT
TTACTAACG	TTCGTTAGT
TTGGTCTTA	TTTAAGACC
TTGGACTTA	TTTAAGTCC
TTGCTGTTA	TTTAACAGC
TTGGAGTTA	TTTAACTCC
TTGCCAATA	TTTATTGGC
TTCGGAATA	TTTATTCCG
TTGCTCATA	TTTATGAGC
TTCGTCATA	TTTATGACG
TTGGTGATA	TTTATCACC
TTGCTTCTA	TTTAGAAGC
TTCGTTCTA	TTTAGAACG
TTTAGTGGA	TTTCCACTA
TTCCTTGTA	TTTACAAGG
TTCGATGTA	TTTACATCG
TTGCTAGTA	TTTACTAGC
TTCGGTTAA	TTTTAACCG
TTGCAGTAA	TTTTACTGC
TTCGCTAAA	TTTTTAGCG
TTCCCAAAA	TTTTTTGGG
TTCCATCAA	TTTTGATGG
TTTCCAGAA	TTTTCTGGA
TTTCGAGAA	TTTTCTCGA
TTCCTTTCA	TTTGAAAGG
TTCCATTCA	TTTGAATGG
TTGGATTCA	TTTGAATCC
TTCGTAACA	TTTGTTACG
TTGTGAACA	TTTGTTCAC
TTCCCTAGA	TTTCTAGGG
TTGAAAAGC	TTGCTTTTC
TTGAGTAGC	TTGCTACTC
TTCGTACTC	TTGAGTACG
TTCAGAGAC	TTGTCTCTG
TTGCTATCC	TTGGATAGC
TTCGTATCC	TTGGATACG
TTCCATACC	TTGGTATGG
TTCTGTACC	TTGGTACAG
TTCAAATCG	TTCGATTTG
TTCAAACTG	TTCAGTTTG
TTCAAGAGG	TTCCTCTTG
TTCAGACTG	TTCAGTCTG
TTCCTACAG	TTCTGTAGG
TTCCTTACG	TTCGTAAGG
TTCCATAGG	TTCCTATGG
