TTAAAAACG	TTCGTTTTT
TTAAAGACC	TTGGTCTTT
TTAATTCCG	TTCGGAATT
TTAATCACG	TTCGTGATT
TTAATCTCC	TTGGAGATT
TTAAGAAGC	TTGCTTCTT
TTAAGAACG	TTCGTTCTT
TTAAGATCC	TTGGATCTT
TTAACATCG	TTCGATGTT
TTAACTCAT	TTATGAGTT
TTATATGCG	TTCGCATAT
TTATAGAGC	TTGCTCTAT
TTATTGAGG	TTCCTCAAT
TTATTCACC	TTGGTGAAT
TTATGAAGG	TTCCTTCAT
TTATGAACC	TTGGTTCAT
TTATCATGG	TTCCATGAT
TTATCAGAC	TTGTCTGAT
TTAGAAACC	TTGGTTTCT
TTAGAATGG	TTCCATTCT
TTAGTATCG	TTCGATACT
TTAGTTACG	TTCGTAACT
TTACTACCT	TTAGGTAGT
TTACAAAGT	TTACTTTGT
TTACAATGT	TTACATTGT
TTACAACAC	TTGTGTTGT
TTACCCTAG	TTCTAGGGT
TTCCACTTA	TTTAAGTGG
TTGCTGTTA	TTTAACAGC
TTGCCAATA	TTTATTGGC
TTCGTCATA	TTTATGACG
TTGGACATA	TTTATGTCC
TTGCTACTA	TTTAGTAGC
TTCGTACTA	TTTAGTACG
TTTAGTCGA	TTTCGACTA
TTCCTTGTA	TTTACAAGG
TTGCTAGTA	TTTACTAGC
TTCGGTTAA	TTTTAACCG
TTGCAGTAA	TTTTACTGC
TTGCCTAAA	TTTTTAGGC
TTCCCAAAA	TTTTTTGGG
TTCCATCAA	TTTTGATGG
TTCGATCAA	TTTTGATCG
TTCTGTCAA	TTTTGACAG
TTTCGAGAA	TTTTCTCGA
TTCCTTTCA	TTTGAAAGG
TTGGATTCA	TTTGAATCC
TTGCTAACA	TTTGTTAGC
TTGAAAAGC	TTGCTTTTC
TTGTCTCAC	TTGTGAGAC
TTCAGTCAC	TTGTGACTG
TTGGTACAC	TTGTGTACC
TTCGTAGAC	TTGTCTACG
TTGCTATCC	TTGGATAGC
TTCGTATCC	TTGGATACG
TTCGTTACC	TTGGTAACG
TTCCATACC	TTGGTATGG
TTCCTTAGC	TTGCTAAGG
TTCAAATCG	TTCGATTTG
TTCAAACTG	TTCAGTTTG
TTCAAGAGG	TTCCTCTTG
TTCAACTTG	TTCAAGTTG
TTCATCTGG	TTCCAGATG
TTCAGGATG	TTCATCCTG
TTCCTACAG	TTCTGTAGG
TTCCTATCG	TTCGATAGG
TTCCTTACG	TTCGTAAGG
