TTCATGG	CCATGAA
GGTTACG	CGTAACC
TAACAGC	GCTGTTA
ATATGCG	CGCATAT
TAGTGGA	TCCACTA
AACATCG	CGATGTT
AGAATGG	CCATTCT
TTTAGCG	CGCTAAA
GCTACAG	CTGTAGC
AGAACTG	CAGTTCT
ACTTCAC	GTGAAGT
AATCACC	GGTGATT
AAGATGG	CCATCTT
ATGTCAC	GTGACAT
AGTATCG	CGATACT
TATTGGC	GCCAATA
CTGTACG	CGTACAG
AATCTGG	CCAGATT
AAGATCC	GGATCTT
ACCCTAG	CTAGGGT
TCATACG	CGTATGA
TTACACG	CGTGTAA
TTTGACC	GGTCAAA
ACATTGA	TCAATGT
TTTCTCG	CGAGAAA
GAGTACC	GGTACTC
ATCTCAC	GTGAGAT
ACTAACG	CGTTAGT
AAGAGAC	GTCTCTT
AGAAACG	CGTTTCT
TCTGATG	CATCAGA
ATTTGGG	CCCAAAT
ATCTACG	CGTAGAT
TATGAGC	GCTCATA
AGAATCC	GGATTCT
ACTAAGC	GCTTAGT
TAGAAGC	GCTTCTA
TATTCCG	CGGAATA
GAGTAGG	CCTACTC
AACAAGA	TCTTGTT
CAAGTTG	CAACTTG
ACAATCG	CGATTGT
TATGACG	CGTCATA
TCATAGC	GCTATGA
TTGATCG	CGATCAA
GTCTACC	GGTAGAC
AGAAAGG	CCTTTCT
TTACTGC	GCAGTAA
CATCCTG	CAGGATG
AACAACC	GGTTGTT
GTGAACC	GGTTCAC
AAGACTG	CAGTCTT
GGATACC	GGTATCC
TAAGTCC	GGACTTA
ATAGTCG	CGACTAT
TACTAGC	GCTAGTA
ACTTACG	CGTAAGT
ACCTCAA	TTGAGGT
CGATAGG	CCTATCG
TCAAACC	GGTTTGA
TAACTCC	GGAGTTA
CTTACCG	CGGTAAG
ATAAGGC	GCCTTAT
ACAAAGT	ACTTTGT
