TTCGTTCTA	TTTAGAACG
TTCAAATCG	TTCGATTTG
TTATTACCC	TTGGGTAAT
TTCAAAGTG	TTCACTTTG
TTCGGTTAA	TTTTAACCG
TTAGAAAGG	TTCCTTTCT
TTCGATCTA	TTTAGATCG
TTAGAAACC	TTGGTTTCT
TTAAAGACC	TTGGTCTTT
TTAAAAACG	TTCGTTTTT
TTCCATTCA	TTTGAATGG
TTCCTATCG	TTCGATAGG
TTGGATTCA	TTTGAATCC
TTATTCTGG	TTCCAGAAT
TTCGTAAGA	TTTCTTACG
TTCGGAATA	TTTATTCCG
TTGAGTACC	TTGGTACTC
TTAAGAGTG	TTCACTCTT
TTACATAGC	TTGCTATGT
TTACATACG	TTCGTATGT
TTAGTTACG	TTCGTAACT
TTGGATACC	TTGGTATCC
TTATACAGC	TTGCTGTAT
TTGCTCATA	TTTATGAGC
TTCAACTTG	TTCAAGTTG
TTCGAGTTA	TTTAACTCG
TTGCCATAA	TTTTATGGC
TTGCCTAAA	TTTTTAGGC
TTCGCTAAA	TTTTTAGCG
TTCCTTGTA	TTTACAAGG
TTACTAAGC	TTGCTTAGT
TTACTAACG	TTCGTTAGT
TTCACTAGG	TTCCTAGTG
TTAAGTAGC	TTGCTACTT
TTATGAAGG	TTCCTTCAT
TTAATCAGG	TTCCTGATT
TTATGAACC	TTGGTTCAT
TTCAAAAGC	TTGCTTTTG
TTAATCACC	TTGGTGATT
TTATTGAGG	TTCCTCAAT
TTCATGTGA	TTTCACATG
TTTAATGCA	TTTGCATTA
TTATGATCC	TTGGATCAT
TTCCTACAC	TTGTGTAGG
TTAAACTGA	TTTCAGTTT
TTAATCTCC	TTGGAGATT
TTCAAACAC	TTGTGTTTG
TTATCTAGC	TTGCTAGAT
TTGGGAAAA	TTTTTTCCC
TTCTCAGAG	TTCTCTGAG
TTCGTAGTA	TTTACTACG
TTATAGACG	TTCGTCTAT
TTATGACAC	TTGTGTCAT
TTCTCTACC	TTGGTAGAG
TTCGTACAA	TTTTGTACG
TTCGATGAA	TTTTCATCG
TTATAGTCG	TTCGACTAT
TTACAATGT	TTACATTGT
TTGGACTTA	TTTAAGTCC
TTAGTATCG	TTCGATACT
TTAACAACA	TTTGTTGTT
TTGCTTCTA	TTTAGAAGC
