TTAAAATGC	TTGCATTTT
TTAAAGTGG	TTCCACTTT
TTAAACTCC	TTGGAGTTT
TTAATACCG	TTCGGTATT
TTAATCAGT	TTACTGATT
TTAAGAAGC	TTGCTTCTT
TTAACAACC	TTGGTTGTT
TTAACTAGC	TTGCTAGTT
TTATAGACG	TTCGTCTAT
TTATAGTCG	TTCGACTAT
TTATTAGGC	TTGCCTAAT
TTATTCACC	TTGGTGAAT
TTACATCAT	TTATGATGT
TTAGTATCG	TTCGATACT
TTACAATGA	TTTCATTGT
TTACATACG	TTCGTATGT
TTACTACAC	TTGTGTAGT
TTGCCAATA	TTTATTGGC
TTGGTCATA	TTTATGACC
TTGTCCATA	TTTATGGAC
TTCGTGATA	TTTATCACG
TTCGTACTA	TTTAGTACG
TTGCTGTAA	TTTTACAGC
TTGCGTAAA	TTTTTACGC
TTCCCAAAA	TTTTTTGGG
TTTCGAGAA	TTTTCTCGA
TTTCTGGAA	TTTTCCAGA
TTGGATTCA	TTTGAATCC
TTCGATTGA	TTTCAATCG
TTGTCTTGA	TTTCAAGAC
TTGCTATGA	TTTCATAGC
TTCCCTAGA	TTTCTAGGG
TTGGTAGGA	TTTCCTACC
TTCAAAGGA	TTTCCTTTG
TTCTGAGGA	TTTCCTCAG
TTGAAAAGC	TTGCTTTTC
TTCGTTTTC	TTGAAAACG
TTGAGATCC	TTGGATCTC
TTCAAACAC	TTGTGTTTG
TTCGTTACC	TTGGTAACG
TTGCTAACC	TTGGTTAGC
TTCTGAACC	TTGGTTCAG
TTCTGACAG	TTCTGTCAG
TTCGTAGAG	TTCTCTACG
