TTAAAAACG	TTCGTTTTT
TTAAAATGC	TTGCATTTT
TTAAAGAGG	TTCCTCTTT
TTAATAGGC	TTGCCTATT
TTAATACCC	TTGGGTATT
TTAATGTCC	TTGGACATT
TTAATCAGG	TTCCTGATT
TTAATCACC	TTGGTGATT
TTAATCTGT	TTACAGATT
TTAATCTCG	TTCGAGATT
TTAAGATCC	TTGGATCTT
TTAAGACAC	TTGTGTCTT
TTAAGTACC	TTGGTACTT
TTAACTTGT	TTACAAGTT
TTAACTCAT	TTATGAGTT
TTATAGAGC	TTGCTCTAT
TTATTGACC	TTGGTCAAT
TTATGATCG	TTCGATCAT
TTATCTACG	TTCGTAGAT
TTAGAATGG	TTCCATTCT
TTAGAATCC	TTGGATTCT
TTAGATGAC	TTGTCATCT
TTAGTATCG	TTCGATACT
TTAGTAGGA	TTTCCTACT
TTAGGTAGA	TTTCTACCT
TTACAATGA	TTTCATTGT
TTACAACTA	TTTAGTTGT
TTACATACG	TTCGTATGT
TTACTAAGC	TTGCTTAGT
TTACTAACG	TTCGTTAGT
TTCGACTTA	TTTAAGTCG
TTCGGAATA	TTTATTCCG
TTGCTTCTA	TTTAGAAGC
TTCGTTCTA	TTTAGAACG
TTGTCACTA	TTTAGTGAC
TTGCTAGTA	TTTACTAGC
TTGTCAGTA	TTTACTGAC
TTCGGTTAA	TTTTAACCG
TTCGCTAAA	TTTTTAGCG
TTGCTGAAA	TTTTTCAGC
TTGCTACAA	TTTTGTAGC
TTCCATGAA	TTTTCATGG
TTTCCAGAA	TTTTCTGGA
TTTGGAGAA	TTTTCTCCA
TTCGTAACA	TTTGTTACG
TTGTGAACA	TTTGTTCAC
TTGCTATGA	TTTCATAGC
TTCGTAAGA	TTTCTTACG
TTCAAAGGA	TTTCCTTTG
TTCAAACAC	TTGTGTTTG
TTCTATCCC	TTGGGATAG
TTCAAAAGC	TTGCTTTTG
TTCAAATCG	TTCGATTTG
