TTAAAGTGG	TTCCACTTT
TTAAACACT	TTAGTGTTT
TTAATGAGG	TTCCTCATT
TTAATGACC	TTGGTCATT
TTAATGTCC	TTGGACATT
TTAATCTCG	TTCGAGATT
TTAAGATGG	TTCCATCTT
TTAAGATCC	TTGGATCTT
TTAAGAGTC	TTGACTCTT
TTAAGACTG	TTCAGTCTT
TTAAGTAGC	TTGCTACTT
TTATATGCG	TTCGCATAT
TTATAGACG	TTCGTCTAT
TTATACTGC	TTGCAGTAT
TTATTGAGC	TTGCTCAAT
TTATTGTCG	TTCGACAAT
TTATTCACG	TTCGTGAAT
TTATGAAGG	TTCCTTCAT
TTATGAACG	TTCGTTCAT
TTAGAATGG	TTCCATTCT
TTAGAATCC	TTGGATTCT
TTAGAAGTC	TTGACTTCT
TTAGAACTG	TTCAGTTCT
TTACAAACC	TTGGTTTGT
TTACTATCG	TTCGATAGT
TTGCTGTTA	TTTAACAGC
TTGGAGTTA	TTTAACTCC
TTGCCAATA	TTTATTGGC
TTCGGAATA	TTTATTCCG
TTCGTACTA	TTTAGTACG
TTGCTTGTA	TTTACAAGC
TTCGTTGTA	TTTACAACG
TTCGATGTA	TTTACATCG
TTCAAGGTA	TTTACCTTG
TTTACCCAA	TTTTGGGTA
TTCGGTTAA	TTTTAACCG
TTCGCTAAA	TTTTTAGCG
TTCGATCAA	TTTTGATCG
TTCCTTTCA	TTTGAAAGG
TTCGTTTCA	TTTGAAACG
TTCGTAACA	TTTGTTACG
TTCGTTAGA	TTTCTAACG
TTCCCTAGA	TTTCTAGGG
TTCGTAAGA	TTTCTTACG
TTCATCAGA	TTTCTGATG
TTCTCTGGA	TTTCCAGAG
TTGACTAGC	TTGCTAGTC
TTCGTAGTC	TTGACTACG
TTGCCTAAC	TTGTTAGGC
TTCTCTCAC	TTGTGAGAG
TTCTGTCAC	TTGTGACAG
TTGCTATCC	TTGGATAGC
TTCGTATCC	TTGGATACG
TTCGATACC	TTGGTATCG
TTCTCTACC	TTGGTAGAG
TTCTGTACC	TTGGTACAG
TTCATCACC	TTGGTGATG
TTCAAATCG	TTCGATTTG
TTCAACTTG	TTCAAGTTG
TTCAACATG	TTCATGTTG
TTCAGGATG	TTCATCCTG
TTCCTACAG	TTCTGTAGG
TTCCATAGG	TTCCTATGG
TTCCTAAGG	TTCCTTAGG
