TAGCAAGGTATAACA	TGTTATACCTTGCTA
CGGTAAGAAATCCCA	TGGGATTTCTTACCG
TCTGTGACGATAGCA	TGCTATCGTCACAGA
GTGCATCCTAATCTA	TAGATTAGGATGCAC
CGGATCTCTTCTCAG	CTGAGAAGAGATCCG
ACAGACTTCATACAT	ATGTATGAAGTCTGT
GACGTAATAATGAGC	GCTCATTATTACGTC
ACGAGTAACCCGAGA	TCTCGGGTTACTCGT
CGATATGCTTAACCC	GGGTTAAGCATATCG
GCAATCTAGTGTGGC	GCCACACTAGATTGC
GCGATGTAGACTACA	TGTAGTCTACATCGC
AGTAGAAACAAGCGG	CCGCTTGTTTCTACT
AATCCTCTTCAGTTC	GAACTGAAGAGGATT
AGCTCTTATATCGTA	TACGATATAAGAGCT
AGTTAATAGAGCCAA	TTGGCTCTATTAACT
ATAGCCATTAAGTGC	GCACTTAATGGCTAT
CAACACTTCCGATTA	TAATCGGAAGTGTTG
AGTCCCAATACTGAG	CTCAGTATTGGGACT
CACCCTTGGAATGAC	GTCATTCCAAGGGTG
AACCATAGAAATCGT	ACGATTTCTATGGTT
GTGGGTGACTGCATA	TATGCAGTCACCCAC
ACCATTTATCGTTCA	TGAACGATAAATGGT
CCGTGGTTCAATAGG	CCTATTGAACCACGG
AGGGTATGATAAAGC	GCTTTATCATACCCT
AGATGTGTTCTGACG	CGTCAGAACACATCT
GCTTGGCGAAATACC	GGTATTTCGCCAAGC
CGACAAGAAAGATCA	TGATCTTTCTTGTCG
CAGACACTTGAGAAA	TTTCTCAAGTGTCTG
ACCTCGGTATGGTAA	TTACCATACCGAGGT
ACGATTAGTTGAAGC	GCTTCAACTAATCGT
AATGCCACTACATCC	GGATGTAGTGGCATT
GCCTATCAACATGTA	TACATGTTGATAGGC
ACTTTCTCCACAGGA	TCCTGTGGAGAAAGT
ATCCATGTCGTGAGG	CCTCACGACATGGAT
GCATCTGATACTGCA	TGCAGTATCAGATGC
AAGGCTAATTACTGG	CCAGTAATTAGCCTT
ACAGTCCACTATACC	GGTATAGTGGACTGT
CCCGACAGTTCTAAG	CTTAGAACTGTCGGG
AACCTAAGAACAGAA	TTCTGTTCTTAGGTT
ACCCAGATCAGGACG	CGTCCTGATCTGGGT
CGGTAGGACAAACAC	GTGTTTGTCCTACCG
CAGTTAGGCATCTCC	GGAGATGCCTAACTG
CGGACATTTACAAGA	TCTTGTAAATGTCCG
CCAAAGTTACGAAGC	GCTTCGTAACTTTGG
CATAGACGGTCTTCC	GGAAGACCGTCTATG
GAGGAATTGCTAGGA	TCCTAGCAATTCCTC
CGGAAATTGAATGTA	TACATTCAATTTCCG
ATCTGTCATTCACGA	TCGTGAATGACAGAT
CCGCTAATCTAAGGA	TCCTTAGATTAGCGG
CGACCAATCTATACG	CGTATAGATTGGTCG
GTAACTCACAGTCGA	TCGACTGTGAGTTAC
AAGATCTACCCAAGG	CCTTGGGTAGATCTT
AGATATTGACGCACA	TGTGCGTCAATATCT
AATCAAATGACGTAG	CTACGTCATTTGATT
CCGTTTATGTGTCAG	CTGACACATAAACGG
GAACATCGGCCATGA	TCATGGCCGATGTTC
GTGCTGTAGCGAACA	TGTTCGCTACAGCAC
ATCACGAGTTAGCTC	GAGCTAACTCGTGAT
CCTTAAAGTGTACCG	CGGTACACTTTAAGG
CAGAATCTTTGCTGC	GCAGCAAAGATTCTG
CAACAACCCATCTGA	TCAGATGGGTTGTTG
ATGTTTGACTCAGAA	TTCTGAGTCAAACAT
CGCATTAACACTGTA	TACAGTGTTAATGCG
CGCGTAAATTCGATC	GATCGAATTTACGCG
AATAAACCATGAGCT	AGCTCATGGTTTATT
CGTAGAAAGCATCAA	TTGATGCTTTCTACG
GCGGGATAATAGTCC	GGACTATTATCCCGC
CAGACAAGTCGTTTA	TAAACGACTTGTCTG
GAAAGGGAGCCTAGC	GCTAGGCTCCCTTTC
AGGTTGACAAAGGTG	CACCTTTGTCAACCT
GCGACAACTCAGGTA	TACCTGAGTTGTCGC
AACGCTTTGCATGTA	TACATGCAAAGCGTT
CATAGTTCCAAACCC	GGGTTTGGAACTATG
ATGGGAATACAACGG	CCGTTGTATTCCCAT
GCTACCAACCGTAAC	GTTACGGTTGGTAGC
CGCCTTCAATAACCA	TGGTTATTGAAGGCG
AAAGGTCTTTAACGC	GCGTTAAAGACCTTT
AAGAAGTACGGCTAA	TTAGCCGTACTTCTT
GCCTCTAGATACTCC	GGAGTATCTAGAGGC
AAACTATGCAATCCA	TGGATTGCATAGTTT
ACCCTACTCTTGCGG	CCGCAAGAGTAGGGT
ACTATCCATACACTC	GAGTGTATGGATAGT
CACCTTAATCTCTCG	CGAGAGATTAAGGTG
GAATCCAACTAGAGC	GCTCTAGTTGGATTC
ACCTCTGACAATAAG	CTTATTGTCAGAGGT
ACCTATCCTGTTGAC	GTCAACAGGATAGGT
CGAACTCCATTATCG	CGATAATGGAGTTCG
GCGGTTACAGAATCC	GGATTCTGTAACCGC
CGTCTAAGTTTCTGC	GCAGAAACTTAGACG
CTCTAAGTCCTCGAA	TTCGAGGACTTAGAG
CGCAAATGCTACAAA	TTTGTAGCATTTGCG
GGCCTTAGGAGACAA	TTGTCTCCTAAGGCC
CAGGTTAATCTGCGG	CCGCAGATTAACCTG
GCATCGTTGAAATCA	TGATTTCAACGATGC
ACTGAGGGTTAGGTG	CACCTAACCCTCAGT
CATGAGACTAGTGAA	TTCACTAGTCTCATG
GCTGATATACGGAAC	GTTCCGTATATCAGC
CGGCTGTTTCATCAG	CTGATGAAACAGCCG
CCACTGAAATAAGGC	GCCTTATTTCAGTGG
CCGTTGCGATCACTA	TAGTGATCGCAACGG
CCAGGAAGAAGATCC	GGATCTTCTTCCTGG
GCACAGACCTAGTCA	TGACTAGGTCTGTGC
CGGTCATCATGAATC	GATTCATGATGACCG
AGCCAAATAGTTCGG	CCGAACTATTTGGCT
ACTGGAAGGTGAAAC	GTTTCACCTTCCAGT
AAAGCGATTACCTCA	TGAGGTAATCGCTTT
CTGTATTTGAGAGCA	TGCTCTCAAATACAG
CAGAATAGGAGTCAG	CTGACTCCTATTCTG
AGACAGCTAGAAGGG	CCCTTCTAGCTGTCT
CGGAGGTTTACATCC	GGATGTAAACCTCCG
CGTCCAGAGAATACC	GGTATTCTCTGGACG
AGACTACTCCAGCCT	AGGCTGGAGTAGTCT
CAATCACCGTGTTGA	TCAACACGGTGATTG
GTCGTTACATGATCA	TGATCATGTAACGAC
GTTGTTCATCGACTA	TAGTCGATGAACAAC
AAGCACTAGGAAAGG	CCTTTCCTAGTGCTT
CACCACAATTTAGGA	TCCTAAATTGTGGTG
CCATCATTAGGACCG	CGGTCCTAATGATGG
ATCCGGTCGATAAGG	CCTTATCGACCGGAT
GGCCAACAGATACAC	GTGTATCTGTTGGCC
GAAACTCTGTCCAAC	GTTGGACAGAGTTTC
AGTATCACAAGGAGG	CCTCCTTGTGATACT
ACGTAAAGATAAGGC	GCCTTATCTTTACGT
GGAGGAACAATCAAA	TTTGATTGTTCCTCC
AACAATCCCTGATGA	TCATCAGGGATTGTT
GGGTACGTATCAGTA	TACTGATACGTACCC
CCCGTAAGTTATGCA	TGCATAACTTACGGG
CCATGTGAATATCGC	GCGATATTCACATGG
ACCAGACTATCTCGA	TCGAGATAGTCTGGT
TAGGGCTACTTGTAA	TTACAAGTAGCCCTA
CCTCTCACCAGTAGC	GCTACTGGTGAGAGG
CCCATAATTTGACCA	TGGTCAAATTATGGG
GGCATTAGATGTGGA	TCCACATCTAATGCC
ACATGCGCTGAATCC	GGATTCAGCGCATGT
AACGTTAACCAATGT	ACATTGGTTAACGTT
ACAAATGTTAGACCC	GGGTCTAACATTTGT
GCGTTTCAAGGAATA	TATTCCTTGAAACGC
GCATTGTAACTAGGC	GCCTAGTTACAATGC
GATGCGAATAATGCC	GGCATTATTCGCATC
GTCCAATGAACGGAA	TTCCGTTCATTGGAC
GAGCTATCATTCTGC	GCAGAATGATAGCTC
CTGCCTATGGACCAA	TTGGTCCATAGGCAG
CCCGTTATAGAGGAA	TTCCTCTATAACGGG
CAGAGAGTAATAGCC	GGCTATTACTCTCTG
ACGAGAAGTAAGTCC	GGACTTACTTCTCGT
AGCGTATACATTCCG	CGGAATGTATACGCT
TAGAGTACAGGTACA	TGTACCTGTACTCTA
ATAAACAGTTGCTCA	TGAGCAACTGTTTAT
CTGCGTGTAGTATAA	TTATACTACACGCAG
CGGCACTCATGAAGC	GCTTCATGAGTGCCG
ACCGAATAGCTACCG	CGGTAGCTATTCGGT
CGCAGTTAAGATACA	TGTATCTTAACTGCG
CCAGTATGAAAGACG	CGTCTTTCATACTGG
CTGCTAGACTTGACC	GGTCAAGTCTAGCAG
CTAATCACTTGCAGA	TCTGCAAGTGATTAG
GGACGGATCGAACAC	GTGTTCGATCCGTCC
CTGAACTTCTACCAA	TTGGTAGAAGTTCAG
ATAGGTTACGCCGCA	TGCGGCGTAACCTAT
GCCTATATGAATGCC	GGCATTCATATAGGC
ACGTAGTTTATTGCC	GGCAATAAACTACGT
ACTAATGGGATCAGA	TCTGATCCCATTAGT
GGTAATCTTATGGCA	TGCCATAAGATTACC
AATCTCAGATAGCGA	TCGCTATCTGAGATT
AAGACGTGTGTTTAT	ATAAACACACGTCTT
ACGATTCACCAAATA	TATTTGGTGAATCGT
GCGGTATATCGAGCA	TGCTCGATATACCGC
CCTTTCAATGTGTGC	GCACACATTGAAAGG
GCAATTAAACCTGGC	GCCAGGTTTAATTGC
GTCAGGTGGAATATA	TATATTCCACCTGAC
ACGTCGAAGGATATA	TATATCCTTCGACGT
AAATCTTTCGGACTC	GAGTCCGAAAGATTT
ATGGTTATCTCCCTG	CAGGGAGATAACCAT
AGGAAGTTTAGCTCG	CGAGCTAAACTTCCT
AGAAAGAGTCTCGTA	TACGAGACTCTTTCT
GTTTGCCAGTCAGTA	TACTGACTGGCAAAC
AGGCAACCTCATTCA	TGAATGAGGTTGCCT
GGGTTCTTACACACC	GGTGTGTAAGAACCC
AAACTGGATTCGTTC	GAACGAATCCAGTTT
GAACATGACTTTCGC	GCGAAAGTCATGTTC
ACTGTATCAATCGAG	CTCGATTGATACAGT
GACTACCTAAAGCTA	TAGCTTTAGGTAGTC
CAAGCTTTGACTACA	TGTAGTCAAAGCTTG
ACTCATCACTCAACT	AGTTGAGTGATGAGT
GTGCTAACCAAACAA	TTGTTTGGTTAGCAC
CGCGAAGATATGGAC	GTCCATATCTTCGCG
AGTACTTTGATGTCG	CGACATCAAAGTACT
AATGGTGGTATCCGA	TCGGATACCACCATT
CTCCATCAGCATAGA	TCTATGCTGATGGAG
CGTTAGTAGGCACAG	CTGTGCCTACTAACG
AGCAACATCTGGTCA	TGACCAGATGTTGCT
GAGAACTTGTTAGCC	GGCTAACAAGTTCTC
GCCCAACTTATGTCC	GGACATAAGTTGGGC
GTGACAGGAATCAAC	GTTGATTCCTGTCAC
