TCAAATTCACCCGAA	TTCGGGTGAATTTGA
ACAATGTGATGGTCG	CGACCATCACATTGT
CACTTCGGTTATCGG	CCGATAACCGAAGTG
CGGTAAGAAATCCCA	TGGGATTTCTTACCG
TCACTGAACTTTGGA	TCCAAAGTTCAGTGA
TAGCCTGAAATACAA	TTGTATTTCAGGCTA
ATCCGCTTTCCGAGA	TCTCGGAAAGCGGAT
CGACCTGTGTCCACC	GGTGGACACAGGTCG
CCAGAATGTACGCAA	TTGCGTACATTCTGG
GAATCGTCTCATGTA	TACATGAGACGATTC
GAGGGTAGCTTATCA	TGATAAGCTACCCTC
GGCCCATAAGTTGCA	TGCAACTTATGGGCC
GATGACTCGCTAATC	GATTAGCGAGTCATC
ACTCTGACAACCTCA	TGAGGTTGTCAGAGT
GCTTAGCACGGAGCC	GGCTCCGTGCTAAGC
GTGCATCCTAATCTA	TAGATTAGGATGCAC
ACCTTCTCCTTTAGC	GCTAAAGGAGAAGGT
AGCCAGTTTGCTACA	TGTAGCAAACTGGCT
CATTGAATGCTGAGC	GCTCAGCATTCAATG
GAGTCGTTTACCTGA	TCAGGTAAACGACTC
ATTAGACCCACTTCC	GGAAGTGGGTCTAAT
CTTCGACAAGTTTCC	GGAAACTTGTCGAAG
TACCAAGAAGCAAGA	TCTTGCTTCTTGGTA
