AAGTTTAACA	TGTTAAACTT
AATTATCTCG	CGAGATAATT
ATCACGGAAA	TTTCCGTGAT
GTGAATTTGA	TCAAATTCAC
CCGAAGGAGC	GCTCCTTCGG
CAACTACTGA	TCAGTAGTTG
AAGATGCTTC	GAAGCATCTT
AAATCGTTTG	CAAACGATTT
CTCTGCTACA	TGTAGCAGAG
GTTCTTACAA	TTGTAAGAAC
AAGTGTCCAA	TTGGACACTT
ATAGTCTAGG	CCTAGACTAT
AAAGCTAACT	AGTTAGCTTT
CACTGACATG	CATGTCAGTG
AGGATGTTTA	TAAACATCCT
ATGAAGTTAA	TTAACTTCAT
AGAAATCCCA	TGGGATTTCT
AGAGTTGTAG	CTACAACTCT
CGACAAGTAA	TTACTTGTCG
GGGAGTATCA	TGATACTCCC
ATCAATTCGC	GCGAATTGAT
TCGGGTATAA	TTATACCCGA
GCCATTACAA	TTGTAATGGC
GATCTATTCC	GGAATAGATC
CGCTAAGAGA	TCTCTTAGCG
