AAGCTGTTTC	GAAACAGCTT
GTTACACGAA	TTCGTGTAAC
CCACATAAGG	CCTTATGTGG
GGTGACAAGA	TCTTGTCACC
AGAATTGCTA	TAGCAATTCT
GAAGTAATCC	GGATTACTTC
GGTCGATATA	TATATCGACC
GCCTTGAAAC	GTTTCAAGGC
AGTTCTAGCG	CGCTAGAACT
CATTCTTGGG	CCCAAGAATG
GGTCTCATGA	TCATGAGACC
ATGTACGCAA	TTGCGTACAT
ACGAAGAGGA	TCCTCTTCGT
GAGTGTCCAA	TTGGACACTC
CCGAGAGTCG	CGACTCTCGG
AATGATTTGA	TCAAATCATT
AGACCCTTTG	CAAAGGGTCT
GGAACGATTA	TAATCGTTCC
GATCCATCAA	TTGATGGATC
AATTCTCCGA	TCGGAGAATT
ACAACTGTAA	TTACAGTTGT
ATCAGTACAT	ATGTACTGAT
CTAAGCACTC	GAGTGCTTAG
GTCTAGGTTA	TAACCTAGAC
AGCTAATTGA	TCAATTAGCT
