GCTTCTCCTAACGCC	GGCGTTAGGAGAAGC
AGATGAATGGTGTGC	GCACACCATTCATCT
CTGCCACGCTCTACA	TGTAGAGCGTGGCAG
TGATACTCCCGCGAA	TTCGCGGGAGTATCA
GGTGCGGACATTCGA	TCGAATGTCCGCACC
GGGAGGTAACGTCGA	TCGACGTTACCTCCC
CTGCAACGAAGAGGA	TCCTCTTCGTTGCAG
AATGCGTAGTTGTGC	GCACAACTACGCATT
AAACCCAGCTTAGCA	TGCTAAGCTGGGTTT
CCATCGCTTGACACG	CGTGTCAAGCGATGG
CCCGAGGTTGTTGTA	TACAACAACCTCGGG
ATGTCTCTTGGCTGG	CCAGCCAAGAGACAT
AACATTTCGCTGAGC	GCTCAGCGAAATGTT
TCGGCAATTTCCAGA	TCTGGAAATTGCCGA
GGCAGTGATACGACA	TGTCGTATCACTGCC
CCTGTAGGAGCTCGC	GCGAGCTCCTACAGG
AGCCTGACCAAACAA	TTGTTTGGTCAGGCT
AACGTCTGGTCTCTC	GAGAGACCAGACGTT
ACCTGGACTAGCGGC	GCCGCTAGTCCAGGT
CGTTCATGTCCATCC	GGATGGACATGAACG
ATGCACATCGGACTG	CAGTCCGATGTGCAT
CTCGGTTCGTGGACC	GGTCCACGAACCGAG
AACTCTCGACCCAAA	TTTGGGTCGAGAGTT
GAGAACACTTGGGCA	TGCCCAAGTGTTCTC
CTAGCCCGGATTCAG	CTGAATCCGGGCTAG
GAGGACAGCAGGATA	TATCCTGCTGTCCTC
GGCTGCTCAAATTCA	TGAATTTGAGCAGCC
GGATGATCGAACGGA	TCCGTTCGATCATCC
GTGGGTGACTGCATA	TATGCAGTCACCCAC
GATCGGTGGAAGGCC	GGCCTTCCACCGATC
ACTCAAGTATCGCCT	AGGCGATACTTGAGT
CAGCTCTGGTGATGG	CCATCACCAGAGCTG
AGAAGTACGGGACCC	GGGTCCCGTACTTCT
AAGCAAAGTCGCAGT	ACTGCGACTTTGCTT
ACATCAGTTACCGGC	GCCGGTAACTGATGT
ACACTGGGATGAGGA	TCCTCATCCCAGTGT
GCACCTTGATCTCCA	TGGAGATCAAGGTGC
GTCAGAGGCCAATGA	TCATTGGCCTCTGAC
