TCAAATTCACCCGAA	TTCGGGTGAATTTGA
CGGTAAGAAATCCCA	TGGGATTTCTTACCG
TAGCCTGAAATACAA	TTGTATTTCAGGCTA
GAATCGTCTCATGTA	TACATGAGACGATTC
GAGGGTAGCTTATCA	TGATAAGCTACCCTC
GCTTAGCACGGAGCC	GGCTCCGTGCTAAGC
ACCTTCTCCTTTAGC	GCTAAAGGAGAAGGT
AGCCAGTTTGCTACA	TGTAGCAAACTGGCT
GAGTCGTTTACCTGA	TCAGGTAAACGACTC
ACAGACTTCATACAT	ATGTATGAAGTCTGT
AACGTGTTCCTAACG	CGTTAGGAACACGTT
GCAATCTAGTGTGGC	GCCACACTAGATTGC
AGCTTCCATCAGCCC	GGGCTGATGGAAGCT
ATCAGCTAGAGGCAA	TTGCCTCTAGCTGAT
AATCACGCTTCGTTG	CAACGAAGCGTGATT
AGATTCGACATCCAC	GTGGATGTCGAATCT
GCGATTAGTAGCCGC	GCGGCTACTAATCGC
CGTGGTCGGACAGAA	TTCTGTCCGACCACG
GTTAAGGTGCTGCCA	TGGCAGCACCTTAAC
GCCGTCATTCGAGTA	TACTCGAATGACGGC
GGCTCAATGCGATAC	GTATCGCATTGAGCC
TAAGAAGAGTTCCGA	TCGGAACTCTTCTTA
AGTCCCAATACTGAG	CTCAGTATTGGGACT
ACCATATTTCTCGGT	ACCGAGAAATATGGT
AAGAGAGAACATTGA	TCAATGTTCTCTCTT
GGCATACGAATTGAC	GTCAATTCGTATGCC
AGGACCTAGTAGATG	CATCTACTAGGTCCT
AGCACTCATTCATGC	GCATGAATGAGTGCT
GTGCTTACTACATCA	TGATGTAGTAAGCAC
GACCAGCAGTTCTAA	TTAGAACTGCTGGTC
ACATTTAGGGAGTCC	GGACTCCCTAAATGT
CGTACCAACAAGGCC	GGCCTTGTTGGTACG
GCCGATAACCGTAAA	TTTACGGTTATCGGC
CGTAGATCGAAACCA	TGGTTTCGATCTACG
CCCAGATACCACTGA	TCAGTGGTATCTGGG
AGGTTGATTCTTTCG	CGAAAGAATCAACCT
GACTGTTTCTTGTGA	TCACAAGAAACAGTC
GAACCTCGCGTTAGA	TCTAACGCGAGGTTC
CCTACGCCAATGGAA	TTCCATTGGCGTAGG
ACCTCTGACAATAAG	CTTATTGTCAGAGGT
ACCAAAGTTTCCTGG	CCAGGAAACTTTGGT
GACACTTTACAAGCC	GGCTTGTAAAGTGTC
