CCAACATTGA	TCAATGTTGG
GTAATGGTTA	TAACCATTAC
GGGATAAACA	TGTTTATCCC
AGGATATCTG	CAGATATCCT
AAGACTTCTA	TAGAAGTCTT
CTTTGACGAA	TTCGTCAAAG
GATGAGCATC	GATGCTCATC
GCTAACTCTA	TAGAGTTAGC
GAACTTTGGA	TCCAAAGTTC
AGTGAATCCA	TGGATTCACT
AGGTCCTTAC	GTAAGGACCT
ACACTGGAAG	CTTCCAGTGT
GCTATACTCA	TGAGTATAGC
TAGCCTGAAA	TTTCAGGCTA
ACTCCACAAC	GTTGTGGAGT
GTGATTTGAA	TTCAAATCAC
AGGTAGATAT	ATATCTACCT
GGGAGGTAAC	GTTACCTCCC
GAAATTTGCA	TGCAAATTTC
AAGCTGTTTC	GAAACAGCTT
GGTGACAAGA	TCTTGTCACC
AGAATTGCTA	TAGCAATTCT
GAAGTAATCC	GGATTACTTC
AGTTCTAGCG	CGCTAGAACT
CCTCAGTAAG	CTTACTGAGG
ATGTACGCAA	TTGCGTACAT
AAATCTTTCT	AGAAAGATTT
GATGATGTCC	GGACATCATC
ACGAAGAGGA	TCCTCTTCGT
CCGAGAGTCG	CGACTCTCGG
GGTCGAAACA	TGTTTCGACC
GAATTAGAGC	GCTCTAATTC
GTAACCGAAC	GTTCGGTTAC
AGGAAACCCT	AGGGTTTCCT
CTAAGCACTC	GAGTGCTTAG
GTCTAGGTTA	TAACCTAGAC
ACTGTATAAA	TTTATACAGT
GGCATTGGCC	GGCCAATGCC
CCCTATATAC	GTATATAGGG
CAAACTAATG	CATTAGTTTG
CGTGTAATAG	CTATTACACG
CACGAAAGTG	CACTTTCGTG
CAACTATGCC	GGCATAGTTG
ACTAAGATGG	CCATCTTAGT
AATATGAAGG	CCTTCATATT
