ATAGTCTAGGAGTTA	TAACTCCTAGACTAT
ATAATTTACTTGTCG	CGACAAGTAAATTAT
GGGATAAACATAACC	GGTTATGTTTATCCC
CTAGAACCACGGAGA	TCTCCGTGGTTCTAG
GTAAGGACCTACTAC	GTAGTAGGTCCTTAC
TAGCCTGAAATACAA	TTGTATTTCAGGCTA
ATTCTGGATTACTTC	GAAGTAATCCAGAAT
CTGATGATGATGTCC	GGACATCATCATCAG
CAGTAAGCGTATTTA	TAAATACGCTTACTG
AATTCACAACTGTAA	TTACAGTTGTGAATT
AAACCCAGCTTAGCA	TGCTAAGCTGGGTTT
CTATTATCAGCGGTC	GACCGCTGATAATAG
CCCAAGATGAGTTGA	TCAACTCATCTTGGG
ACCTTCTCCTTTAGC	GCTAAAGGAGAAGGT
CCGAAGAGTAGCAAC	GTTGCTACTCTTCGG
AAAGGGCTCTGTACC	GGTACAGAGCCCTTT
AGAAATTTGAATGGG	CCCATTCAAATTTCT
ATATCTTCTAGCTCC	GGAGCTAGAAGATAT
GTCATGGATAGGAAA	TTTCCTATCCATGAC
GCAATCTAGTGTGGC	GCCACACTAGATTGC
ATACAATCCCAAACA	TGTTTGGGATTGTAT
AGCTTTATATGTGTA	TACACATATAAAGCT
CTGAGAGAGTAAAGA	TCTTTACTCTCTCAG
TAAATATGTTGACGA	TCGTCAACATATTTA
TGTCTATGGCAATAA	TTATTGCCATAGACA
ATTTCTTTGGATCTC	GAGATCCAAAGAAAT
ACTTTAGTGACCCTG	CAGGGTCACTAAAGT
CGAATCGGATCATAC	GTATGATCCGATTCG
CCTCTTTCTTCATAA	TTATGAAGAAAGAGG
ATACGATGCAAGATC	GATCTTGCATCGTAT
GATCAAGACACTGAA	TTCAGTGTCTTGATC
ACTGCCGTAAATCAC	GTGATTTACGGCAGT
ATAGAATTACCTGCG	CGCAGGTAATTCTAT
AGTCGAGTCTTCCAG	CTGGAAGACTCGACT
ACCAATACTAATCGC	GCGATTAGTATTGGT
GTCCCTAATAATTGA	TCAATTATTAGGGAC
CAGCACAATATTCAG	CTGAATATTGTGCTG
ATCTCACAAGCAGAC	GTCTGCTTGTGAGAT
AAGTCGCTATGAACC	GGTTCATAGCGACTT
AATTGGTTTAAGTCC	GGACTTAAACCAATT
CACCCTTGGAATGAC	GTCATTCCAAGGGTG
CTTTCAATGAGACCA	TGGTCTCATTGAAAG
TCTGACCATCCTTAA	TTAAGGATGGTCAGA
AGACTGTGATATCTA	TAGATATCACAGTCT
CAAAGTGGTGTATCG	CGATACACCACTTTG
AATGCTAACAGAACG	CGTTCTGTTAGCATT
GTACCTAGTTTCGTA	TACGAAACTAGGTAC
