GGATGTTCTAGATTTCTCGA	TCGAGAAATCTAGAACATCC
ACAACTGTAATTTGACGAAC	GTTCGTCAAATTACAGTTGT
AGGGTTTCCTAACTGCTACC	GGTAGCAGTTAGGAAACCCT
CCCGAACTTAGAGTGCTTAG	CTAAGCACTCTAAGTTCGGG
CAGCCCGACTGCGTCAGCCG	CGGCTGACGCAGTCGGGCTG
CTACGTGGATCCTACCCACC	GGTGGGTAGGATCCACGTAG
AAGTCTGTTGCTATTACACG	CGTGTAATAGCAACAGACTT
CGCACACCCTGATTCGTGAG	CTCACGAATCAGGGTGTGCG
GCTTCCGGCTACGGCGTGAA	TTCACGCCGTAGCCGGAAGC
ATCCTATCATCCGGTAAGCG	CGCTTACCGGATGATAGGAT
TCAGTTAGTCATCGATATCA	TGATATCGATGACTAACTGA
ACCTTCTCCTTTAGCGAACC	GGTTCGCTAAAGGAGAAGGT
CGTTTAAGCCTAGCTGTGCC	GGCACAGCTAGGCTTAAACG
CGCAGTGCTCCTAGAGCTCA	TGAGCTCTAGGAGCACTGCG
CAATCTCGAGTCTATGTCGA	TCGACATAGACTCGAGATTG
ACGATTACAATTTAACCCAT	ATGGGTTAAATTGTAATCGT
AGGTCCTTAGCTCCATGAGC	GCTCATGGAGCTAAGGACCT
GAGGCGTCCGCTATCTCGCA	TGCGAGATAGCGGACGCCTC
CAAAGGACGACTTAAGCATA	TATGCTTAAGTCGTCCTTTG
GCTCGTCGGCAATAAGAGCC	GGCTCTTATTGCCGACGAGC
AGTCGAAGCGCGTATGTCGC	GCGACATACGCGCTTCGACT
TTGGGTCTAGTGCATCCAAA	TTTGGATGCACTAGACCCAA
AATTTCCAGAGCCACACTAG	CTAGTGTGGCTCTGGAAATT
ATTGCCATTGTTCCAACGTA	TACGTTGGAACAATGGCAAT
AGATGCCTATCCACTTTGCC	GGCAAAGTGGATAGGCATCT
CCAGAAGCCTGTACAACCGC	GCGGTTGTACAGGCTTCTGG
ACGACTCTAGGAATCGCATG	CATGCGATTCCTAGAGTCGT
CTAATGCGTTCTATCGTGGA	TCCACGATAGAACGCATTAG
ACCTTCAGATGCTGTTAAAC	GTTTAACAGCATCTGAAGGT
TCTAATCCGTCACCGCGAAA	TTTCGCGGTGACGGATTAGA
GTCCTCGCGGCTGAGCGAAA	TTTCGCTCAGCCGCGAGGAC
ATAGGAGAGAATTCGTCTGG	CCAGACGAATTCTCTCCTAT
CTGGTATGCTACGCAGCCTC	GAGGCTGCGTAGCATACCAG
AGCATGGGACTTACTTTATA	TATAAAGTAAGTCCCATGCT
AGCTGATACGATGCAAGATC	GATCTTGCATCGTATCAGCT
CCAGGGTCGTTGTCTGGAGC	GCTCCAGACAACGACCCTGG
ATCTAGTTCATTGGGTACCG	CGGTACCCAATGAACTAGAT
CAATTGGCACGTAGGGCGCG	CGCGCCCTACGTGCCAATTG
ACTATCTCATCGGGTTCGAG	CTCGAACCCGATGAGATAGT
AGCAAGAATTACTGTCTGCC	GGCAGACAGTAATTCTTGCT
GGAACCCTCAAGATTTACAA	TTGTAAATCTTGAGGGTTCC
AGATTCGACATCCACCGAAG	CTTCGGTGGATGTCGAATCT
GAACTAAGTTGAGAGCTGGC	GCCAGCTCTCAACTTAGTTC
CGTAAGGCTGATGCCCACCC	GGGTGGGCATCAGCCTTACG
GAAATAAATCCTGGTACGTC	GACGTACCAGGATTTATTTC
CTCCTTGATGTCATTCTGGA	TCCAGAATGACATCAAGGAG
CTTGAGCAGAAAGATAAAGC	GCTTTATCTTTCTGCTCAAG
GCGATTAGTATTGGTAAGTA	TACTTACCAATACTAATCGC
CATTGTCCTCATCTGTCTTC	GAAGACAGATGAGGACAATG
CGAGTGAAATCCACGGCCTC	GAGGCCGTGGATTTCACTCG
GGTGCTGCCACCAAGCCCTA	TAGGGCTTGGTGGCAGCACC
ATGTCCGATTTAGTTAGCAC	GTGCTAACTAAATCGGACAT
CTTCCTTGCACACAATAGGC	GCCTATTGTGTGCAAGGAAG
GCAATCTTCTTTGAATGCCC	GGGCATTCAAAGAAGATTGC
