GACGTTATTGATCGTTTGGA	TCCAAACGATCAATAACGTC
AGGGTTTCCTAACTGCTACC	GGTAGCAGTTAGGAAACCCT
TAACCTAGACAGCTAATTGA	TCAATTAGCTGTCTAGGTTA
AATTGGTACGTAAGGCGCTG	CAGCGCCTTACGTACCAATT
GTTGAGCTATGAGCGAGTTA	TAACTCGCTCATAGCTCAAC
ACTGTTTATCCACGAAAGTG	CACTTTCGTGGATAAACAGT
CTAGCCACCGGCATCTAACC	GGTTAGATGCCGGTGGCTAG
GCCTTATTGATTCAAACAAC	GTTGTTTGAATCAATAAGGC
GCTTCCGGCTACGGCGTGAA	TTCACGCCGTAGCCGGAAGC
CCCGATACGCCAAGCGGTCA	TGACCGCTTGGCGTATCGGG
ACCTTCTCCTTTAGCGAACC	GGTTCGCTAAAGGAGAAGGT
TGTAGCAAACTGGCTCTCAA	TTGAGAGCCAGTTTGCTACA
GGCCATCTCGCCAGGATGGA	TCCATCCTGGCGAGATGGCC
CGCAGTGCTCCTAGAGCTCA	TGAGCTCTAGGAGCACTGCG
AATTCCCACCTATGCTCTAG	CTAGAGCATAGGTGGGAATT
CCACTTCTCGTCTGGTGTAA	TTACACCAGACGAGAAGTGG
CAATCTCGAGTCTATGTCGA	TCGACATAGACTCGAGATTG
ACGATTACAATTTAACCCAT	ATGGGTTAAATTGTAATCGT
AGGTCCTTAGCTCCATGAGC	GCTCATGGAGCTAAGGACCT
GCTCGTCGGCAATAAGAGCC	GGCTCTTATTGCCGACGAGC
CATTTGGCCTCTTGTCTCTA	TAGAGACAAGAGGCCAAATG
AGTCGAAGCGCGTATGTCGC	GCGACATACGCGCTTCGACT
ATGATACAACATCTATGGGC	GCCCATAGATGTTGTATCAT
AATTGAACGTGTTCCTAACG	CGTTAGGAACACGTTCAATT
AAAGGCTCACATAGCCGGGA	TCCCGGCTATGTGAGCCTTT
TTGGGTCTAGTGCATCCAAA	TTTGGATGCACTAGACCCAA
TATATGTGTAGCACAGCCGA	TCGGCTGTGCTACACATATA
ACCTAATGGAACCTGTAATA	TATTACAGGTTCCATTAGGT
ACCTTCAGATGCTGTTAAAC	GTTTAACAGCATCTGAAGGT
AAGACTATATCCTGGTCACT	AGTGACCAGGATATAGTCTT
CTGGTATGCTACGCAGCCTC	GAGGCTGCGTAGCATACCAG
ACTGAGGATATGTTAACTCC	GGAGTTAACATATCCTCAGT
AAGTGGTAGTTCAGTACGTC	GACGTACTGAACTACCACTT
CTCTCTTTGGTGAGTCACAC	GTGTGACTCACCAAAGAGAG
AAATCGGCTTCCACCCGACG	CGTCGGGTGGAAGCCGATTT
AAAGCCCAGTCCTTGAGCTG	CAGCTCAAGGACTGGGCTTT
CGTCGCATCAGCGGCTATAA	TTATAGCCGCTGATGCGACG
ACTATCTCATCGGGTTCGAG	CTCGAACCCGATGAGATAGT
AGCAAGAATTACTGTCTGCC	GGCAGACAGTAATTCTTGCT
CAGCGTAAGTGTATAACGAG	CTCGTTATACACTTACGCTG
AGGTTGAATATAGTGTTGGC	GCCAACACTATATTCAACCT
AGACTTCGTTCTGTGAATCC	GGATTCACAGAACGAAGTCT
AGGGCGACTAGCTTGTACTG	CAGTACAAGCTAGTCGCCCT
AATGAGGTTTGTCGTTGATC	GATCAACGACAAACCTCATT
ATGTAGTTGTATTTCTGACG	CGTCAGAAATACAACTACAT
CTCCTTGATGTCATTCTGGA	TCCAGAATGACATCAAGGAG
GGAACGCTCTGCGGCGTTGA	TCAACGCCGCAGAGCGTTCC
CAAGTATCAGTCAGCTTTCA	TGAAAGCTGACTGATACTTG
ATGTTTCAACATGTGCAAAT	ATTTGCACATGTTGAAACAT
TCTACATGCCACAATGTTAA	TTAACATTGTGGCATGTAGA
GAGCCTAAGTTCGAGCAGAA	TTCTGCTCGAACTTAGGCTC
ATGTCCGATTTAGTTAGCAC	GTGCTAACTAAATCGGACAT
CGTGCTTAATCTTTATACGA	TCGTATAAAGATTAAGCACG
ACGCACACACGAATACCGTC	GACGGTATTCGTGTGTGCGT
GTTGCTCAATTTACCGCAGA	TCTGCGGTAAATTGAGCAAC
AATGATAGGGAAGACACTCT	AGAGTGTCTTCCCTATCATT
GCAATCTTCTTTGAATGCCC	GGGCATTCAAAGAAGATTGC
CCCGGAGCTATCTCTGCTTA	TAAGCAGAGATAGCTCCGGG
ACCCTCCAGGAGTCCCTCCT	AGGAGGGACTCCTGGAGGGT
CCTGTCGGATGCGATATCTC	GAGATATCGCATCCGACAGG
TCCATCTGTGGAGGTCAACA	TGTTGACCTCCACAGATGGA
AATGAGACCAGTCATTCCAA	TTGGAATGACTGGTCTCATT
