TTAAAGGTA	TTTACCTTT
TTAATGTCC	TTGGACATT
TTAAGAGGA	TTTCCTCTT
TTAACTTGT	TTACAAGTT
TTATAGTCG	TTCGACTAT
TTAGAACAC	TTGTGTTCT
TTAGTATCG	TTCGATACT
TTACAATGA	TTTCATTGT
TTACATCTC	TTGAGATGT
TTCCGTATA	TTTATACGG
TTCTCTGTA	TTTACAGAG
TTGTTGGTA	TTTACCAAC
TTCGCTTAA	TTTTAAGCG
TTCCCAAAA	TTTTTTGGG
TTGTGTCAA	TTTTGACAC
TTCGTTTGA	TTTCAAACG
TTGAAATGC	TTGCATTTC
TTCGAGTTC	TTGAACTCG
TTGCCATAC	TTGTATGGC
TTGCCTAAC	TTGTTAGGC
TTGGATCAC	TTGTGATCC
TTCCTACAC	TTGTGTAGG
TTCAAATCG	TTCGATTTG
TTCATCAGG	TTCCTGATG
TTCAGACTG	TTCAGTCTG
TTCTAGCAG	TTCTGCTAG
