TTAAAACCC	TTGGGTTTT
TTAAAGGAC	TTGTCCTTT
TTAATAGGC	TTGCCTATT
TTAAGACTC	TTGAGTCTT
TTAACTTGA	TTTCAAGTT
TTATATGCG	TTCGCATAT
TTATCTACG	TTCGTAGAT
TTACAAACA	TTTGTTTGT
TTACAATGT	TTACATTGT
TTACATACG	TTCGTATGT
TTACTGTTA	TTTAACAGT
TTACCTAAC	TTGTTAGGT
TTCGGATTA	TTTAATCCG
TTGCTTCTA	TTTAGAAGC
TTCGTCAAA	TTTTTGACG
TTCCATCAA	TTTTGATGG
TTCCATTCA	TTTGAATGG
TTGAGTTCA	TTTGAACTC
TTCATCTGA	TTTCAGATG
TTGTAGGGA	TTTCCCTAC
TTGAAAAGC	TTGCTTTTC
TTGAGATCC	TTGGATCTC
TTGAGTACC	TTGGTACTC
TTCCACTAC	TTGTAGTGG
TTCGGTAAC	TTGTTACCG
TTCAGGAAC	TTGTTCCTG
TTGTGACAC	TTGTGTCAC
TTGGTAGAC	TTGTCTACC
TTCAACTGG	TTCCAGTTG
