TTAAAATGC	TTGCATTTT
TTAAGTTGA	TTTCAACTT
TTAACAAGA	TTTCTTGTT
TTAACTAGC	TTGCTAGTT
TTAACTGTA	TTTACAGTT
TTATAGAGC	TTGCTCTAT
TTATAGACG	TTCGTCTAT
TTATAGGTG	TTCACCTAT
TTATTACGC	TTGCGTAAT
TTATCAGGA	TTTCCTGAT
TTAGAAAGC	TTGCTTTCT
TTAGATACG	TTCGTATCT
TTAGTACAC	TTGTGTACT
TTACAATGT	TTACATTGT
TTACTAAGC	TTGCTTAGT
TTGGTCATA	TTTATGACC
TTCTCCATA	TTTATGGAG
TTTATCCGA	TTTCGGATA
TTGCCTTAA	TTTTAAGGC
TTGCCAAAA	TTTTTTGGC
TTGCTTCAA	TTTTGAAGC
TTGCTACAA	TTTTGTAGC
TTGGAATCA	TTTGATTCC
TTGGATTGA	TTTCAATCC
TTGCTATGA	TTTCATAGC
TTGTGATGA	TTTCATCAC
TTCAAGTGA	TTTCACTTG
TTCTGAGGA	TTTCCTCAG
TTCGTTTTC	TTGAAAACG
TTCGTTCTC	TTGAGAACG
TTCGTTACC	TTGGTAACG
TTCCTAACC	TTGGTTAGG
TTCATACCC	TTGGGTATG
TTCTGACAG	TTCTGTCAG
