TTAAAGAGC	TTGCTCTTT
TTAAAGTCG	TTCGACTTT
TTAATCACG	TTCGTGATT
TTAAGATGG	TTCCATCTT
TTAAGATCC	TTGGATCTT
TTAACAAGG	TTCCTTGTT
TTAACATCG	TTCGATGTT
TTAACTCAT	TTATGAGTT
TTATATGCG	TTCGCATAT
TTATAGACG	TTCGTCTAT
TTATTCACC	TTGGTGAAT
TTATGATCG	TTCGATCAT
TTATCTACG	TTCGTAGAT
TTATCTGGA	TTTCCAGAT
TTAGAAACC	TTGGTTTCT
TTAGAATCG	TTCGATTCT
TTAGTATCG	TTCGATACT
TTAGGTACT	TTAGTACCT
TTACAAACT	TTAGTTTGT
TTAGTTCTG	TTCAGAACT
TTAGGGTAG	TTCTACCCT
TTACAATGT	TTACATTGT
TTACATACG	TTCGTATGT
TTACAGTTA	TTTAACTGT
TTACTTACC	TTGGTAAGT
TTCCTGTTA	TTTAACAGG
TTGCCTATA	TTTATAGGC
TTCGGAATA	TTTATTCCG
TTGCTACTA	TTTAGTAGC
TTTAGTGGA	TTTCCACTA
TTCGTTGTA	TTTACAACG
TTCCATGTA	TTTACATGG
TTGCTAGTA	TTTACTAGC
TTCGGTTAA	TTTTAACCG
TTCGCTAAA	TTTTTAGCG
TTGGTTCAA	TTTTGAACC
TTTCCTCAA	TTTTGAGGA
TTGTGTCAA	TTTTGACAC
TTTGTCCAA	TTTTGGACA
TTTCGAGAA	TTTTCTCGA
TTCCTTTCA	TTTGAAAGG
TTGAAAAGC	TTGCTTTTC
TTCGTTTTC	TTGAAAACG
TTGTCTCAC	TTGTGAGAC
TTCGTACAC	TTGTGTACG
TTGGATACC	TTGGTATCC
TTCGTTACC	TTGGTAACG
TTCGATAGC	TTGCTATCG
TTCAACTTG	TTCAAGTTG
TTCAGAAGG	TTCCTTCTG
TTCAGACTG	TTCAGTCTG
TTCCTAAGG	TTCCTTAGG
