TTAAAATGC	TTGCATTTT
TTAAAGAGC	TTGCTCTTT
TTAATTCCG	TTCGGAATT
TTAATGAGG	TTCCTCATT
TTAATGTCT	TTAGACATT
TTAATCACC	TTGGTGATT
TTAAGAACC	TTGGTTCTT
TTAAGATGG	TTCCATCTT
TTAAGATCC	TTGGATCTT
TTAACATCG	TTCGATGTT
TTATAGTGG	TTCCACTAT
TTATGAAGG	TTCCTTCAT
TTATCATGG	TTCCATGAT
TTATCAGGA	TTTCCTGAT
TTATCTAGC	TTGCTAGAT
TTATCTACG	TTCGTAGAT
TTAGAAAGG	TTCCTTTCT
TTAGAATCC	TTGGATTCT
TTAGACTCT	TTAGAGTCT
TTAGTATCG	TTCGATACT
TTACAAAGT	TTACTTTGT
TTACAATCG	TTCGATTGT
TTACAACTA	TTTAGTTGT
TTACATAGC	TTGCTATGT
TTACATACG	TTCGTATGT
TTACTACAC	TTGTGTAGT
TTACTTAGC	TTGCTAAGT
TTACTTACG	TTCGTAAGT
TTACTTCTG	TTCAGAAGT
TTCGAGTTA	TTTAACTCG
TTGGTCATA	TTTATGACC
TTCGTACTA	TTTAGTACG
TTCCTTGTA	TTTACAAGG
TTGCGTTAA	TTTTAACGC
TTTCCCTAA	TTTTAGGGA
TTGCTGTAA	TTTTACAGC
TTCGTCAAA	TTTTTGACG
TTCGTGAAA	TTTTTCACG
TTCGATCAA	TTTTGATCG
TTGGTTTCA	TTTGAAACC
TTCCATTCA	TTTGAATGG
TTCAGTTCA	TTTGAACTG
TTGCTAACA	TTTGTTAGC
TTCGTAACA	TTTGTTACG
TTCTCTCCA	TTTGGAGAG
TTCTCTGGA	TTTCCAGAG
TTGGTAGGA	TTTCCTACC
TTGATAGGC	TTGCCTATC
TTGTGACAC	TTGTGTCAC
TTCAAACAC	TTGTGTTTG
TTGGATACC	TTGGTATCC
TTCAAGTCC	TTGGACTTG
TTCTTACCC	TTGGGTAAG
TTCAGTAGC	TTGCTACTG
TTCGGTTAG	TTCTAACCG
TTCGACTAG	TTCTAGTCG
