TTAAAAACG	TTCGTTTTT
TTAAAGAGC	TTGCTCTTT
TTAAAGACG	TTCGTCTTT
TTAAACACC	TTGGTGTTT
TTAATCAGG	TTCCTGATT
TTAATCTCC	TTGGAGATT
TTAAGAACG	TTCGTTCTT
TTAAGATGG	TTCCATCTT
TTAACATCG	TTCGATGTT
TTAACTACC	TTGGTAGTT
TTATATGCC	TTGGCATAT
TTATAGTCG	TTCGACTAT
TTATACAGC	TTGCTGTAT
TTATTAGCC	TTGGCTAAT
TTATGAAGG	TTCCTTCAT
TTATGATCG	TTCGATCAT
TTATGAGAC	TTGTCTCAT
TTATCTAGC	TTGCTAGAT
TTAGAATGG	TTCCATTCT
TTAGTAACC	TTGGTTACT
TTAGTATCG	TTCGATACT
TTACAAAGG	TTCCTTTGT
TTACAAGTA	TTTACTTGT
TTACATACG	TTCGTATGT
TTACATTGA	TTTCAATGT
TTACTAGGG	TTCCCTAGT
TTCGGTTTA	TTTAAACCG
TTCCACTTA	TTTAAGTGG
TTGGACTTA	TTTAAGTCC
TTCGAGTTA	TTTAACTCG
TTCGGAATA	TTTATTCCG
TTGGTCATA	TTTATGACC
TTCGTGATA	TTTATCACG
TTGCTTCTA	TTTAGAAGC
TTCACTCTA	TTTAGAGTG
TTGCTACTA	TTTAGTAGC
TTGCAGTAA	TTTTACTGC
TTGCGTAAA	TTTTTACGC
TTCCCAAAA	TTTTTTGGG
TTTCCAGAA	TTTTCTGGA
TTCGATTCA	TTTGAATCG
TTCTGTTCA	TTTGAACAG
TTGGATTGA	TTTCAATCC
TTCAGTTGA	TTTCAACTG
TTGTTGTGA	TTTCACAAC
TTGAAAAGC	TTGCTTTTC
TTCGTACTC	TTGAGTACG
TTGAGGTAC	TTGTACCTC
TTCCATGTC	TTGACATGG
TTCGTAGAC	TTGTCTACG
TTGGATACC	TTGGTATCC
TTCAGATCC	TTGGATCTG
TTCCTTACC	TTGGTAAGG
TTCGATAGC	TTGCTATCG
TTCAGACTG	TTCAGTCTG
TTCCTAACG	TTCGTTAGG
TTCCATAGG	TTCCTATGG
TTCCTAAGG	TTCCTTAGG
