TTAAAGAGC	TTGCTCTTT
TTAAAGTCC	TTGGACTTT
TTAATCAGG	TTCCTGATT
TTAATCTCC	TTGGAGATT
TTAAGATGG	TTCCATCTT
TTAAGATCC	TTGGATCTT
TTAAGACTC	TTGAGTCTT
TTAACATCG	TTCGATGTT
TTAACTTGT	TTACAAGTT
TTATATGCG	TTCGCATAT
TTATAGACG	TTCGTCTAT
TTATTACCC	TTGGGTAAT
TTATTGAGG	TTCCTCAAT
TTATGAAGG	TTCCTTCAT
TTATGATCG	TTCGATCAT
TTATCTAGC	TTGCTAGAT
TTATCTACG	TTCGTAGAT
TTAGAAACC	TTGGTTTCT
TTAGAATGG	TTCCATTCT
TTAGTATCG	TTCGATACT
TTACTACCT	TTAGGTAGT
TTACAAAGG	TTCCTTTGT
TTACAATGT	TTACATTGT
TTACAACTA	TTTAGTTGT
TTACATACG	TTCGTATGT
TTACTAAGC	TTGCTTAGT
TTACTAGGG	TTCCCTAGT
TTGCTGTTA	TTTAACAGC
TTGCCAATA	TTTATTGGC
TTCGGAATA	TTTATTCCG
TTGGTCATA	TTTATGACC
TTGGTGATA	TTTATCACC
TTGCTTCTA	TTTAGAAGC
TTTAGTGGA	TTTCCACTA
TTTAGTCGA	TTTCGACTA
TTCCATGTA	TTTACATGG
TTCGGTTAA	TTTTAACCG
TTGCCTAAA	TTTTTAGGC
TTCGCTAAA	TTTTTAGCG
TTGTGTCAA	TTTTGACAC
TTTCCAGAA	TTTTCTGGA
TTTCGAGAA	TTTTCTCGA
TTGGATTCA	TTTGAATCC
TTGAGTTCA	TTTGAACTC
TTCGTAACA	TTTGTTACG
TTCCTCTGA	TTTCAGAGG
TTCGTAAGA	TTTCTTACG
TTGAAAAGC	TTGCTTTTC
TTCGTTTTC	TTGAAAACG
TTGTCTCAC	TTGTGAGAC
TTGCTACAC	TTGTGTAGC
TTCAAACAC	TTGTGTTTG
TTGGATACC	TTGGTATCC
TTCAGTACC	TTGGTACTG
TTCGATAGC	TTGCTATCG
TTCAAATCG	TTCGATTTG
TTCAGTAGG	TTCCTACTG
TTCGTACAG	TTCTGTACG
TTCCTAACG	TTCGTTAGG
