TTAAAAACG	TTCGTTTTT
TTAAAATGC	TTGCATTTT
TTAAATCCG	TTCGGATTT
TTAATGTCG	TTCGACATT
TTAATCACC	TTGGTGATT
TTAAGAAGG	TTCCTTCTT
TTAAGAACC	TTGGTTCTT
TTAAGTAGC	TTGCTACTT
TTAAGTGTA	TTTACACTT
TTAACATCC	TTGGATGTT
TTAACTTCC	TTGGAAGTT
TTATTAGGC	TTGCCTAAT
TTATTACGC	TTGCGTAAT
TTATGATCC	TTGGATCAT
TTATGTACC	TTGGTACAT
TTATCAGGA	TTTCCTGAT
TTATCTAGC	TTGCTAGAT
TTATCTACG	TTCGTAGAT
TTACAAGAT	TTATCTTGT
TTAGAAAGC	TTGCTTTCT
TTAGATTCC	TTGGAATCT
TTAGTATCG	TTCGATACT
TTACAAACT	TTAGTTTGT
TTACTACCT	TTAGGTAGT
TTACAAAGG	TTCCTTTGT
TTACAATGA	TTTCATTGT
TTGGGTTTA	TTTAAACCC
TTGCTCTTA	TTTAAGAGC
TTGGACTTA	TTTAAGTCC
TTCGAGTTA	TTTAACTCG
TTGCCAATA	TTTATTGGC
TTGGTCATA	TTTATGACC
TTCTCCATA	TTTATGGAG
TTCGATCTA	TTTAGATCG
TTCGTACTA	TTTAGTACG
TTGGAACTA	TTTAGTTCC
TTCGGTTAA	TTTTAACCG
TTGCTGTAA	TTTTACAGC
TTCGTGAAA	TTTTTCACG
TTGCTTCAA	TTTTGAAGC
TTTCCTCAA	TTTTGAGGA
TTCGTTGAA	TTTTCAACG
TTCGATGAA	TTTTCATCG
TTCTGTTCA	TTTGAACAG
TTGTTGTCA	TTTGACAAC
TTGCTAACA	TTTGTTAGC
TTCGATTGA	TTTCAATCG
TTGCTATGA	TTTCATAGC
TTCGTATGA	TTTCATACG
TTGTAGGGA	TTTCCCTAC
TTCCTAGTC	TTGACTAGG
TTCAGAGTC	TTGACTCTG
TTCGTCTAC	TTGTAGACG
TTCTCTCAC	TTGTGAGAG
TTGGATACC	TTGGTATCC
TTGCTTACC	TTGGTAAGC
TTCGTTACC	TTGGTAACG
TTCCTTAGC	TTGCTAAGG
TTCAGACTG	TTCAGTCTG
TTCCTATCG	TTCGATAGG
